t,deaths,cases,cases_cum,nCFR,cases_adj,cases_adj_cum,date
46,0,2,2,0.0,0.0,0.0,2020-02-15
47,0,2,4,0.0,0.0,0.0,2020-02-16
49,0,1,5,0.0,0.0,0.0,2020-02-18
50,0,2,7,0.0,0.0,0.0,2020-02-19
51,3,9,16,0.3333333333333333,500.0,500.0,2020-02-20
52,2,3,19,0.6666666666666666,333.3333333333333,833.3333333333333,2020-02-21
53,4,12,31,0.3333333333333333,666.6666666666666,1500.0,2020-02-22
54,1,70,101,0.014285714285714285,166.66666666666666,1666.6666666666667,2020-02-23
55,0,115,216,0.0,0.0,1666.6666666666667,2020-02-24
56,3,163,379,0.018404907975460124,500.0,2166.666666666667,2020-02-25
57,3,147,526,0.02040816326530612,500.0,2666.666666666667,2020-02-26
58,2,142,668,0.014084507042253521,333.3333333333333,3000.0000000000005,2020-02-27
59,5,218,886,0.022935779816513763,833.3333333333334,3833.333333333334,2020-02-28
60,3,98,984,0.030612244897959183,500.0,4333.333333333334,2020-02-29
61,20,883,1867,0.022650056625141562,3333.3333333333335,7666.666666666668,2020-03-01
62,15,336,2203,0.044642857142857144,2500.0,10166.666666666668,2020-03-02
63,12,361,2564,0.0332409972299169,2000.0,12166.666666666668,2020-03-03
64,6,221,2785,0.027149321266968326,1000.0,13166.666666666668,2020-03-04
65,21,586,3371,0.03583617747440273,3500.0,16666.666666666668,2020-03-05
66,16,286,3657,0.055944055944055944,2666.6666666666665,19333.333333333336,2020-03-06
67,9,255,3912,0.03529411764705882,1500.0,20833.333333333336,2020-03-07
68,20,299,4211,0.06688963210702341,3333.3333333333335,24166.666666666668,2020-03-08
69,19,392,4603,0.04846938775510204,3166.6666666666665,27333.333333333336,2020-03-09
70,41,1142,5745,0.03590192644483362,6833.333333333333,34166.66666666667,2020-03-10
71,43,465,6210,0.09247311827956989,7166.666666666667,41333.333333333336,2020-03-11
72,60,664,6874,0.09036144578313253,10000.0,51333.333333333336,2020-03-12
73,63,844,7718,0.07464454976303317,10500.0,61833.333333333336,2020-03-13
74,69,912,8630,0.0756578947368421,11500.0,73333.33333333334,2020-03-14
75,89,2021,10651,0.04403760514596734,14833.333333333332,88166.66666666667,2020-03-15
76,114,1612,12263,0.0707196029776675,19000.0,107166.66666666667,2020-03-16
77,98,1399,13662,0.07005003573981415,16333.333333333332,123500.0,2020-03-17
78,150,2738,16400,0.0547845142439737,25000.0,148500.0,2020-03-18
79,133,1506,17906,0.08831341301460824,22166.666666666668,170666.66666666666,2020-03-19
80,237,3351,21257,0.07072515666965085,39500.0,210166.66666666666,2020-03-20
81,171,1594,22851,0.10727728983688833,28500.0,238666.66666666666,2020-03-21
82,178,1750,24601,0.10171428571428572,29666.666666666664,268333.3333333333,2020-03-22
83,272,2504,27105,0.10862619808306709,45333.333333333336,313666.6666666666,2020-03-23
84,218,2084,29189,0.10460652591170826,36333.333333333336,349999.99999999994,2020-03-24
85,241,9575,38764,0.02516971279373368,40166.666666666664,390166.6666666666,2020-03-25
86,244,2249,41013,0.1084926634059582,40666.666666666664,430833.3333333333,2020-03-26
87,241,2344,43357,0.10281569965870307,40166.666666666664,471000.0,2020-03-27
88,229,2323,45680,0.09857942315970727,38166.666666666664,509166.6666666667,2020-03-28
89,240,2114,47794,0.11352885525070956,40000.0,549166.6666666667,2020-03-29
90,296,3368,51162,0.08788598574821853,49333.333333333336,598500.0000000001,2020-03-30
91,282,2110,53272,0.13364928909952606,47000.0,645500.0000000001,2020-03-31
92,494,5277,58549,0.0936137957172636,82333.33333333333,727833.3333333335,2020-04-01
93,375,3211,61760,0.11678604796013703,62500.0,790333.3333333335,2020-04-02
94,394,3412,65172,0.11547479484173505,65666.66666666667,856000.0000000001,2020-04-03
95,409,3464,68636,0.1180715935334873,68166.66666666667,924166.6666666667,2020-04-04
96,416,15992,84628,0.026013006503251626,69333.33333333333,993500.0000000001,2020-04-05
97,468,5025,89653,0.09313432835820895,78000.0,1071500.0,2020-04-06
98,433,3791,93444,0.11421788446320232,72166.66666666667,1143666.6666666667,2020-04-07
99,487,4104,97548,0.11866471734892788,81166.66666666667,1224833.3333333335,2020-04-08
100,500,6599,104147,0.07576905591756326,83333.33333333333,1308166.6666666667,2020-04-09
101,790,7755,111902,0.10186976144422953,131666.66666666666,1439833.3333333335,2020-04-10
102,543,4407,116309,0.12321307011572498,90500.0,1530333.3333333335,2020-04-11
103,636,5352,121661,0.11883408071748879,106000.0,1636333.3333333335,2020-04-12
104,676,6799,128460,0.0994263862332696,112666.66666666667,1749000.0000000002,2020-04-13
105,742,6189,134649,0.11989012764582324,123666.66666666666,1872666.666666667,2020-04-14
106,883,8652,143301,0.10205732778548313,147166.66666666666,2019833.3333333337,2020-04-15
107,738,7669,150970,0.09623158169252836,123000.0,2142833.333333334,2020-04-16
108,832,6917,157887,0.1202833598380801,138666.66666666666,2281500.0000000005,2020-04-17
109,929,21090,178977,0.0440493124703651,154833.33333333334,2436333.333333334,2020-04-18
110,868,6633,185610,0.1308608472787577,144666.66666666666,2581000.0000000005,2020-04-19
111,1479,13429,199039,0.1101347829324596,246500.0,2827500.0000000005,2020-04-20
112,834,11796,210835,0.07070193285859613,139000.0,2966500.0000000005,2020-04-21
113,971,8575,219410,0.11323615160349854,161833.33333333334,3128333.333333334,2020-04-22
114,959,8507,227917,0.1127306923709886,159833.33333333334,3288166.6666666674,2020-04-23
115,1114,9884,237801,0.11270740590853905,185666.66666666666,3473833.333333334,2020-04-24
116,1137,10729,248530,0.10597446173921149,189500.0,3663333.333333334,2020-04-25
117,1060,13103,261633,0.08089750438830802,176666.66666666666,3840000.0000000005,2020-04-26
118,1155,11208,272841,0.10305139186295503,192500.0,4032500.0000000005,2020-04-27
119,1240,11465,284306,0.10815525512429132,206666.66666666666,4239166.666666667,2020-04-28
120,994,9607,293913,0.10346622254606017,165666.66666666666,4404833.333333334,2020-04-29
121,1330,23780,317693,0.05592935239697225,221666.66666666666,4626500.000000001,2020-04-30
122,2014,27539,345232,0.07313264824430807,335666.6666666667,4962166.666666668,2020-05-01
123,1317,13925,359157,0.09457809694793537,219500.0,5181666.666666668,2020-05-02
124,1251,12759,371916,0.09804843639783682,208500.0,5390166.666666668,2020-05-03
125,1377,21128,393044,0.06517417644831504,229500.0,5619666.666666668,2020-05-04
126,1428,19763,412807,0.07225623640135607,238000.0,5857666.666666668,2020-05-05
127,1140,13946,426753,0.08174386920980926,190000.0,6047666.666666668,2020-05-06
128,1207,14283,441036,0.08450605615066863,201166.66666666666,6248833.333333335,2020-05-07
129,1275,16960,457996,0.07517688679245282,212500.0,6461333.333333335,2020-05-08
130,1207,14561,472557,0.08289265847125885,201166.66666666666,6662500.000000002,2020-05-09
131,1775,25582,498139,0.06938472363380502,295833.3333333333,6958333.333333335,2020-05-10
132,1228,17949,516088,0.06841606774750683,204666.66666666666,7163000.000000002,2020-05-11
133,1166,18570,534658,0.06278944534194938,194333.33333333334,7357333.333333335,2020-05-12
134,1153,16043,550701,0.07186935111886804,192166.66666666666,7549500.000000002,2020-05-13
135,1152,16833,567534,0.06843699875245055,192000.0,7741500.000000002,2020-05-14
136,1424,26002,593536,0.05476501807553265,237333.3333333333,7978833.333333335,2020-05-15
137,1082,16178,609714,0.06688094943750773,180333.33333333334,8159166.666666668,2020-05-16
138,1041,15876,625590,0.06557067271352986,173500.0,8332666.666666668,2020-05-17
139,1184,22258,647848,0.053194357085093,197333.33333333334,8530000.000000002,2020-05-18
140,1031,17833,665681,0.057814164750743004,171833.33333333334,8701833.333333336,2020-05-19
141,1517,28894,694575,0.05250224960199349,252833.3333333333,8954666.66666667,2020-05-20
142,995,17551,712126,0.05669192638596091,165833.33333333334,9120500.000000004,2020-05-21
143,1013,19262,731388,0.05259059287716748,168833.33333333334,9289333.333333338,2020-05-22
144,945,15939,747327,0.05928853754940711,157500.0,9446833.333333338,2020-05-23
145,998,15126,762453,0.06597910881925162,166333.33333333334,9613166.666666672,2020-05-24
146,1305,27229,789682,0.0479268427044695,217500.0,9830666.666666672,2020-05-25
147,965,19425,809107,0.04967824967824968,160833.33333333334,9991500.000000006,2020-05-26
148,880,18423,827530,0.04776637898279325,146666.66666666666,10138166.666666672,2020-05-27
149,937,21393,848923,0.0437993736268873,156166.66666666666,10294333.333333338,2020-05-28
150,913,20277,869200,0.04502638457365488,152166.66666666666,10446500.000000004,2020-05-29
151,862,20425,889625,0.042203182374541,143666.66666666666,10590166.66666667,2020-05-30
152,844,15389,905014,0.0548443693547339,140666.66666666666,10730833.333333336,2020-05-31
153,1623,38387,943401,0.04227993852085341,270500.0,11001333.333333336,2020-06-01
154,1060,23368,966769,0.045361177678877096,176666.66666666666,11178000.000000002,2020-06-02
155,979,21729,988498,0.045054995627962634,163166.66666666666,11341166.666666668,2020-06-03
156,962,21238,1009736,0.04529616724738676,160333.33333333334,11501500.000000002,2020-06-04
157,1079,28268,1038004,0.03817036932220178,179833.33333333334,11681333.333333336,2020-06-05
158,957,22532,1060536,0.04247292739215338,159500.0,11840833.333333336,2020-06-06
159,867,18505,1079041,0.0468522021075385,144500.0,11985333.333333336,2020-06-07
160,999,26184,1105225,0.03815307057745188,166500.0,12151833.333333336,2020-06-08
161,897,22692,1127917,0.03952934955050238,149500.0,12301333.333333336,2020-06-09
162,1279,34262,1162179,0.03732998657404705,213166.66666666666,12514500.000000002,2020-06-10
163,851,20607,1182786,0.041296646770514873,141833.33333333334,12656333.333333336,2020-06-11
164,961,26279,1209065,0.03656912363484151,160166.66666666666,12816500.000000002,2020-06-12
165,919,20709,1229774,0.04437684098701048,153166.66666666666,12969666.666666668,2020-06-13
166,950,21321,1251095,0.044557009521129405,158333.33333333334,13128000.000000002,2020-06-14
167,1164,37286,1288381,0.031218151585045324,194000.0,13322000.000000002,2020-06-15
168,967,31755,1320136,0.03045189733900173,161166.66666666666,13483166.666666668,2020-06-16
169,873,25140,1345276,0.034725536992840096,145500.0,13628666.666666668,2020-06-17
170,1004,27725,1373001,0.03621280432822362,167333.33333333334,13796000.000000002,2020-06-18
171,991,27300,1400301,0.0363003663003663,165166.66666666666,13961166.666666668,2020-06-19
172,1228,34780,1435081,0.03530764807360552,204666.66666666666,14165833.333333334,2020-06-20
173,780,19652,1454733,0.039690616731121516,130000.0,14295833.333333334,2020-06-21
174,969,29768,1484501,0.03255173340499866,161500.0,14457333.333333334,2020-06-22
175,884,25523,1510024,0.034635426869882066,147333.33333333334,14604666.666666668,2020-06-23
176,877,25256,1535280,0.03472442191954387,146166.66666666666,14750833.333333334,2020-06-24
177,1049,31613,1566893,0.03318255148198526,174833.33333333334,14925666.666666668,2020-06-25
178,1005,30729,1597622,0.03270526213023528,167500.0,15093166.666666668,2020-06-26
179,831,23858,1621480,0.03483108391315282,138500.0,15231666.666666668,2020-06-27
180,903,25633,1647113,0.035228026372254514,150500.0,15382166.666666668,2020-06-28
181,878,30401,1677514,0.028880628926680044,146333.33333333334,15528500.000000002,2020-06-29
182,1074,32360,1709874,0.03318912237330037,179000.0,15707500.000000002,2020-06-30
183,1539,44614,1754488,0.03449589814856323,256500.0,15964000.000000002,2020-07-01
184,1031,30953,1785441,0.03330856459793881,171833.33333333334,16135833.333333336,2020-07-02
185,1068,34663,1820104,0.030810951158295588,178000.0,16313833.333333336,2020-07-03
186,976,26276,1846380,0.03714416197290303,162666.66666666666,16476500.000000002,2020-07-04
187,999,28758,1875138,0.03473815981639892,166500.0,16643000.000000002,2020-07-05
188,1085,35772,1910910,0.0303309851280331,180833.33333333334,16823833.333333336,2020-07-06
189,1040,32852,1943762,0.031657128941921346,173333.33333333334,16997166.666666668,2020-07-07
190,1009,30700,1974462,0.03286644951140065,168166.66666666666,17165333.333333336,2020-07-08
191,948,28976,2003438,0.032716731087796797,158000.0,17323333.333333336,2020-07-09
192,1484,44786,2048224,0.03313535479837449,247333.3333333333,17570666.666666668,2020-07-10
193,885,25606,2073830,0.03456221198156682,147500.0,17718166.666666668,2020-07-11
194,919,25475,2099305,0.03607458292443572,153166.66666666666,17871333.333333336,2020-07-12
195,945,36350,2135655,0.025997248968363137,157500.0,18028833.333333336,2020-07-13
196,940,30184,2165839,0.03114232706069441,156666.66666666666,18185500.000000004,2020-07-14
197,1047,34974,2200813,0.029936524275175846,174500.0,18360000.000000004,2020-07-15
198,936,28276,2229089,0.03310227754986561,156000.0,18516000.000000004,2020-07-16
199,974,34324,2263413,0.028376646078545623,162333.33333333334,18678333.333333336,2020-07-17
200,937,27948,2291361,0.03352654930585373,156166.66666666666,18834500.000000004,2020-07-18
201,900,25165,2316526,0.03576395787800517,150000.0,18984500.000000004,2020-07-19
202,1362,46452,2362978,0.02932058899509171,227000.0,19211500.000000004,2020-07-20
203,830,28369,2391347,0.029257287884662836,138333.33333333334,19349833.333333336,2020-07-21
204,882,28201,2419548,0.03127548668486933,147000.0,19496833.333333336,2020-07-22
205,809,30003,2449551,0.026963970269639703,134833.33333333334,19631666.666666668,2020-07-23
206,863,30183,2479734,0.02859225391776828,143833.33333333334,19775500.0,2020-07-24
207,918,29155,2508889,0.0314868804664723,153000.0,19928500.0,2020-07-25
208,786,23329,2532218,0.03369197136611085,131000.0,20059500.0,2020-07-26
209,961,35091,2567309,0.027385939414664728,160166.66666666666,20219666.666666668,2020-07-27
210,821,28844,2596153,0.028463458604909165,136833.33333333334,20356500.0,2020-07-28
211,712,25628,2621781,0.02778211331356329,118666.66666666666,20475166.666666668,2020-07-29
212,756,28849,2650630,0.02620541439911262,126000.0,20601166.666666668,2020-07-30
213,768,28590,2679220,0.026862539349422874,128000.0,20729166.666666668,2020-07-31
214,1192,37433,2716653,0.03184356049475062,198666.66666666666,20927833.333333336,2020-08-01
215,787,24718,2741371,0.03183914556193867,131166.66666666666,21059000.000000004,2020-08-02
216,811,31925,2773296,0.025403288958496476,135166.66666666666,21194166.66666667,2020-08-03
217,718,26324,2799620,0.027275490047105302,119666.66666666666,21313833.33333334,2020-08-04
218,753,28213,2827833,0.026689823840073724,125500.0,21439333.33333334,2020-08-05
219,692,26302,2854135,0.026309786328035892,115333.33333333333,21554666.66666667,2020-08-06
220,786,29316,2883451,0.026811297584936552,131000.0,21685666.66666667,2020-08-07
221,809,25259,2908710,0.032028187972603823,134833.33333333334,21820500.000000004,2020-08-08
222,655,22055,2930765,0.029698481070052143,109166.66666666667,21929666.66666667,2020-08-09
223,1151,40407,2971172,0.028485163461776423,191833.33333333334,22121500.000000004,2020-08-10
224,648,26202,2997374,0.024730936569727503,108000.0,22229500.000000004,2020-08-11
225,732,26920,3024294,0.027191679049034176,122000.0,22351500.000000004,2020-08-12
226,733,24991,3049285,0.029330559001240448,122166.66666666666,22473666.66666667,2020-08-13
227,702,28255,3077540,0.024845160148646257,117000.0,22590666.66666667,2020-08-14
228,774,25350,3102890,0.030532544378698224,129000.0,22719666.66666667,2020-08-15
229,656,19583,3122473,0.033498442526681306,109333.33333333333,22829000.000000004,2020-08-16
230,665,28624,3151097,0.02323225265511459,110833.33333333333,22939833.333333336,2020-08-17
231,662,25663,3176760,0.02579589291976776,110333.33333333333,23050166.666666668,2020-08-18
232,615,22467,3199227,0.02737348110562158,102500.0,23152666.666666668,2020-08-19
233,963,31659,3230886,0.030417890647209324,160500.0,23313166.666666668,2020-08-20
234,658,24512,3255398,0.026843994778067884,109666.66666666667,23422833.333333336,2020-08-21
235,550,19728,3275126,0.027879156528791565,91666.66666666667,23514500.000000004,2020-08-22
236,564,18325,3293451,0.03077762619372442,94000.0,23608500.000000004,2020-08-23
237,604,25927,3319378,0.023296177729779766,100666.66666666667,23709166.66666667,2020-08-24
238,641,25723,3345101,0.024919332892741904,106833.33333333333,23816000.000000004,2020-08-25
239,610,21670,3366771,0.02814951545916013,101666.66666666667,23917666.66666667,2020-08-26
240,575,21634,3388405,0.026578533789405567,95833.33333333333,24013500.000000004,2020-08-27
241,685,25760,3414165,0.0265916149068323,114166.66666666667,24127666.66666667,2020-08-28
242,493,19714,3433879,0.025007608805924723,82166.66666666667,24209833.33333334,2020-08-29
243,557,16841,3450720,0.033074045484234905,92833.33333333333,24302666.66666667,2020-08-30
244,602,22997,3473717,0.026177327477497066,100333.33333333333,24403000.000000004,2020-08-31
245,917,30883,3504600,0.029692711200336754,152833.33333333334,24555833.333333336,2020-09-01
246,556,22580,3527180,0.02462356067316209,92666.66666666667,24648500.000000004,2020-09-02
247,568,19420,3546600,0.029248197734294542,94666.66666666667,24743166.66666667,2020-09-03
248,557,20621,3567221,0.027011299161049416,92833.33333333333,24836000.000000004,2020-09-04
249,565,17840,3585061,0.03167040358744395,94166.66666666667,24930166.66666667,2020-09-05
250,465,14651,3599712,0.03173844788751621,77500.0,25007666.66666667,2020-09-06
251,561,17743,3617455,0.03161810291382517,93500.0,25101166.66666667,2020-09-07
252,528,21563,3639018,0.024486388721420952,88000.0,25189166.66666667,2020-09-08
253,535,19932,3658950,0.026841260284968894,89166.66666666667,25278333.33333334,2020-09-09
254,726,25334,3684284,0.028657140601563116,121000.0,25399333.33333334,2020-09-10
255,492,19821,3704105,0.02482215831693658,82000.0,25481333.33333334,2020-09-11
256,478,15746,3719851,0.03035691604216944,79666.66666666667,25561000.000000007,2020-09-12
257,480,14591,3734442,0.03289699129600439,80000.0,25641000.000000007,2020-09-13
258,562,21589,3756031,0.026031775441196905,93666.66666666667,25734666.666666675,2020-09-14
259,514,20406,3776437,0.025188669999019895,85666.66666666667,25820333.333333343,2020-09-15
260,429,16780,3793217,0.025566150178784268,71500.0,25891833.333333343,2020-09-16
261,539,17409,3810626,0.03096099718536389,89833.33333333333,25981666.666666675,2020-09-17
262,481,19399,3830025,0.024795092530542812,80166.66666666667,26061833.333333343,2020-09-18
263,442,14831,3844856,0.029802440833389524,73666.66666666667,26135500.00000001,2020-09-19
264,634,19026,3863882,0.0333228214022916,105666.66666666667,26241166.66666668,2020-09-20
265,459,19300,3883182,0.023782383419689117,76500.0,26317666.66666668,2020-09-21
266,394,16618,3899800,0.02370923095438681,65666.66666666667,26383333.333333347,2020-09-22
267,438,16155,3915955,0.02711234911792015,73000.0,26456333.333333347,2020-09-23
268,429,16158,3932113,0.02655031563312291,71500.0,26527833.333333347,2020-09-24
269,491,19792,3951905,0.02480800323362975,81833.33333333333,26609666.66666668,2020-09-25
270,374,14225,3966130,0.026291739894551844,62333.33333333333,26672000.00000001,2020-09-26
271,384,12324,3978454,0.0311587147030185,64000.0,26736000.00000001,2020-09-27
272,424,18596,3997050,0.022800602280060228,70666.66666666667,26806666.66666668,2020-09-28
273,421,15487,4012537,0.02718408988183638,70166.66666666667,26876833.333333347,2020-09-29
274,426,16026,4028563,0.026581804567577687,71000.0,26947833.333333347,2020-09-30
275,685,21914,4050477,0.031258556174135255,114166.66666666667,27062000.000000015,2020-10-01
276,474,16825,4067302,0.028172362555720653,79000.0,27141000.000000015,2020-10-02
277,352,12908,4080210,0.027269910133250697,58666.666666666664,27199666.666666683,2020-10-03
278,354,11360,4091570,0.031161971830985916,59000.0,27258666.666666683,2020-10-04
279,426,18203,4109773,0.023402735812778113,71000.0,27329666.666666683,2020-10-05
280,410,14681,4124454,0.02792725291192698,68333.33333333333,27398000.000000015,2020-10-06
281,384,14384,4138838,0.026696329254727477,64000.0,27462000.000000015,2020-10-07
282,394,16303,4155141,0.024167331166043058,65666.66666666667,27527666.666666683,2020-10-08
283,400,17563,4172704,0.022775152308831065,66666.66666666667,27594333.33333335,2020-10-09
284,561,19566,4192270,0.0286721864458755,93500.0,27687833.33333335,2020-10-10
285,309,11228,4203498,0.027520484503028145,51500.0,27739333.33333335,2020-10-11
286,349,14424,4217922,0.024195784803105934,58166.666666666664,27797500.00000002,2020-10-12
287,345,17618,4235540,0.0195822454308094,57500.0,27855000.00000002,2020-10-13
288,347,16457,4251997,0.021085252476149965,57833.333333333336,27912833.33333335,2020-10-14
289,431,19027,4271024,0.022652020812529563,71833.33333333333,27984666.666666683,2020-10-15
290,394,18671,4289695,0.021102244121900274,65666.66666666667,28050333.33333335,2020-10-16
291,329,16129,4305824,0.020398040796081592,54833.333333333336,28105166.666666683,2020-10-17
292,362,14965,4320789,0.024189776144336785,60333.33333333333,28165500.000000015,2020-10-18
293,393,19700,4340489,0.019949238578680202,65500.0,28231000.000000015,2020-10-19
294,514,21090,4361579,0.024371740161213844,85666.66666666667,28316666.666666683,2020-10-20
295,385,15609,4377188,0.02466525722339676,64166.666666666664,28380833.33333335,2020-10-21
296,344,16301,4393489,0.021102999815962212,57333.333333333336,28438166.666666683,2020-10-22
297,370,17447,4410936,0.021207084312489254,61666.666666666664,28499833.33333335,2020-10-23
298,330,13010,4423946,0.02536510376633359,55000.0,28554833.33333335,2020-10-24
299,420,14555,4438501,0.028856063208519408,70000.0,28624833.33333335,2020-10-25
300,359,18279,4456780,0.019640024071338694,59833.33333333333,28684666.666666683,2020-10-26
301,360,16005,4472785,0.022492970946579195,60000.0,28744666.666666683,2020-10-27
302,413,16103,4488888,0.025647394895361112,68833.33333333333,28813500.000000015,2020-10-28
303,371,15533,4504421,0.023884632717440287,61833.33333333333,28875333.333333347,2020-10-29
304,427,16401,4520822,0.026034997865983782,71166.66666666667,28946500.000000015,2020-10-30
305,341,12830,4533652,0.026578332034294622,56833.333333333336,29003333.333333347,2020-10-31
306,669,21148,4554800,0.031634197087195004,111500.0,29114833.333333347,2020-11-01
307,448,17694,4572494,0.0253193172826947,74666.66666666667,29189500.000000015,2020-11-02
308,429,20638,4593132,0.020786897955228218,71500.0,29261000.000000015,2020-11-03
309,411,18879,4612011,0.02177022088034324,68500.0,29329500.000000015,2020-11-04
310,517,20947,4632958,0.02468133861650833,86166.66666666667,29415666.666666683,2020-11-05
311,552,21110,4654068,0.026148744670772144,92000.0,29507666.666666683,2020-11-06
312,541,17998,4672066,0.03005889543282587,90166.66666666667,29597833.33333335,2020-11-07
313,574,18365,4690431,0.03125510481894909,95666.66666666667,29693500.00000002,2020-11-08
314,571,25330,4715761,0.02254243979470983,95166.66666666667,29788666.666666687,2020-11-09
315,764,27700,4743461,0.027581227436823105,127333.33333333333,29916000.00000002,2020-11-10
316,573,22075,4765536,0.02595696489241223,95500.0,30011500.00000002,2020-11-11
317,584,22529,4788065,0.025922144791158064,97333.33333333333,30108833.33333335,2020-11-12
318,618,25442,4813507,0.0242905431962896,103000.0,30211833.33333335,2020-11-13
319,643,22276,4835783,0.02886514634584306,107166.66666666667,30319000.00000002,2020-11-14
320,744,26887,4862670,0.02767136534384647,124000.0,30443000.00000002,2020-11-15
321,696,31072,4893742,0.02239958805355304,116000.0,30559000.00000002,2020-11-16
322,695,27668,4921410,0.025119271360416365,115833.33333333333,30674833.33333335,2020-11-17
323,733,28709,4950119,0.025532063116095998,122166.66666666666,30797000.00000002,2020-11-18
324,762,29582,4979701,0.025758907443715773,127000.0,30924000.00000002,2020-11-19
325,1114,40640,5020341,0.027411417322834645,185666.66666666666,31109666.666666687,2020-11-20
326,623,27236,5047577,0.022874137171390807,103833.33333333333,31213500.00000002,2020-11-21
327,714,27909,5075486,0.025583145221971408,119000.0,31332500.00000002,2020-11-22
328,867,37749,5113235,0.022967495827704045,144500.0,31477000.00000002,2020-11-23
329,720,30353,5143588,0.023720884261852204,120000.0,31597000.00000002,2020-11-24
330,947,33833,5177421,0.027990423550970946,157833.33333333334,31754833.33333335,2020-11-25
331,756,30622,5208043,0.024688132715041472,126000.0,31880833.33333335,2020-11-26
332,830,33845,5241888,0.02452356330329443,138333.33333333334,32019166.666666683,2020-11-27
333,785,29542,5271430,0.02657233768871437,130833.33333333333,32150000.000000015,2020-11-28
334,702,26383,5297813,0.02660804305802979,117000.0,32267000.000000015,2020-11-29
335,1085,41676,5339489,0.02603416834629043,180833.33333333334,32447833.333333347,2020-11-30
336,1453,43228,5382717,0.0336124733968724,242166.66666666666,32690000.000000015,2020-12-01
337,929,31930,5414647,0.029094895082994048,154833.33333333334,32844833.333333347,2020-12-02
338,893,31039,5445686,0.028770256773736267,148833.33333333334,32993666.66666668,2020-12-03
339,886,34642,5480328,0.025575890537497835,147666.66666666666,33141333.333333347,2020-12-04
340,929,31385,5511713,0.029600127449418513,154833.33333333334,33296166.66666668,2020-12-05
341,786,27423,5539136,0.02866207198337162,131000.0,33427166.66666668,2020-12-06
342,968,36850,5575986,0.02626865671641791,161333.33333333334,33588500.000000015,2020-12-07
343,910,31530,5607516,0.02886140183951792,151666.66666666666,33740166.66666668,2020-12-08
344,843,31227,5638743,0.02699586895955423,140500.0,33880666.66666668,2020-12-09
345,1252,38015,5676758,0.03293436801262659,208666.66666666666,34089333.33333334,2020-12-10
346,851,32984,5709742,0.025800388066941547,141833.33333333334,34231166.66666668,2020-12-11
347,834,29565,5739307,0.028209030948756975,139000.0,34370166.66666668,2020-12-12
348,872,26350,5765657,0.03309297912713473,145333.33333333334,34515500.000000015,2020-12-13
349,931,36508,5802165,0.0255012599978087,155166.66666666666,34670666.66666668,2020-12-14
350,1002,32691,5834856,0.03065063779021749,167000.0,34837666.66666668,2020-12-15
351,749,27818,5862674,0.02692501258178158,124833.33333333333,34962500.000000015,2020-12-16
352,818,28991,5891665,0.02821565313373116,136333.33333333334,35098833.33333335,2020-12-17
353,928,31891,5923556,0.029099118873663416,154666.66666666666,35253500.000000015,2020-12-18
354,780,24129,5947685,0.03232624642546313,130000.0,35383500.000000015,2020-12-19
355,1203,28480,5976165,0.04224016853932584,200500.0,35584000.000000015,2020-12-20
356,856,29000,6005165,0.029517241379310343,142666.66666666666,35726666.66666668,2020-12-21
357,785,26290,6031455,0.0298592620768353,130833.33333333333,35857500.000000015,2020-12-22
358,882,29560,6061015,0.029837618403247633,147000.0,36004500.000000015,2020-12-23
359,914,28635,6089650,0.03191898026890169,152333.33333333334,36156833.33333335,2020-12-24
360,1049,30753,6120403,0.034110493285207946,174833.33333333334,36331666.66666669,2020-12-25
361,968,30707,6151110,0.031523756798124206,161333.33333333334,36493000.00000002,2020-12-26
362,972,28255,6179365,0.034400990975048666,162000.0,36655000.00000002,2020-12-27
363,1118,35772,6215137,0.03125349435312535,186333.33333333334,36841333.33333336,2020-12-28
364,847,27546,6242683,0.030748566034996008,141166.66666666666,36982500.00000002,2020-12-29
365,1018,32438,6275121,0.03138294592761576,169666.66666666666,37152166.66666669,2020-12-30
366,1012,32560,6307681,0.031081081081081083,168666.66666666666,37320833.33333335,2020-12-31
367,1877,51306,6358987,0.0365844150781585,312833.3333333333,37633666.66666669,2021-01-01
368,1177,41110,6400097,0.028630503527122354,196166.66666666666,37829833.33333335,2021-01-02
369,1195,41132,6441229,0.029052805601478167,199166.66666666666,38029000.000000015,2021-01-03
370,1297,50605,6491834,0.025629878470506868,216166.66666666666,38245166.66666668,2021-01-04
371,1263,42127,6533961,0.029980772426234956,210500.0,38455666.66666668,2021-01-05
372,1091,36461,6570422,0.02992238281999945,181833.33333333334,38637500.000000015,2021-01-06
373,1139,36250,6606672,0.03142068965517241,189833.33333333334,38827333.33333335,2021-01-07
374,1181,40433,6647105,0.029208814582148246,196833.33333333334,39024166.66666669,2021-01-08
375,1041,34465,6681570,0.030204555346003192,173500.0,39197666.66666669,2021-01-09
376,1653,40948,6722518,0.04036827195467422,275500.0,39473166.66666669,2021-01-10
377,1105,40197,6762715,0.027489613652760155,184166.66666666666,39657333.33333335,2021-01-11
378,994,34418,6797133,0.02888023708524609,165666.66666666666,39823000.000000015,2021-01-12
379,977,31875,6829008,0.030650980392156864,162833.33333333334,39985833.33333335,2021-01-13
380,1036,33131,6862139,0.03126980773293894,172666.66666666666,40158500.000000015,2021-01-14
381,1292,40487,6902626,0.03191147775829278,215333.33333333334,40373833.33333335,2021-01-15
382,979,29477,6932103,0.03321233504087933,163166.66666666666,40537000.000000015,2021-01-16
383,919,28666,6960769,0.03205888509035094,153166.66666666666,40690166.66666668,2021-01-17
384,1077,39120,6999889,0.027530674846625768,179500.0,40869666.66666668,2021-01-18
385,889,31774,7031663,0.027978850632592686,148166.66666666666,41017833.33333334,2021-01-19
386,1355,37166,7068829,0.0364580530592477,225833.33333333334,41243666.66666668,2021-01-20
387,906,30320,7099149,0.02988126649076517,151000.0,41394666.66666668,2021-01-21
388,919,32289,7131438,0.028461705224689524,153166.66666666666,41547833.33333334,2021-01-22
389,881,26885,7158323,0.03276920215733681,146833.33333333334,41694666.66666668,2021-01-23
390,871,26938,7185261,0.0323335065706437,145166.66666666666,41839833.33333334,2021-01-24
391,1129,37054,7222315,0.030469045177308793,188166.66666666666,42028000.00000001,2021-01-25
392,876,28049,7250364,0.031231059930835324,146000.0,42174000.00000001,2021-01-26
393,858,27149,7277513,0.031603373973258686,143000.0,42317000.00000001,2021-01-27
394,945,29171,7306684,0.03239518700078845,157500.0,42474500.00000001,2021-01-28
395,811,27374,7334058,0.02962665302842113,135166.66666666666,42609666.66666667,2021-01-29
396,799,24208,7358266,0.03300561797752809,133166.66666666666,42742833.333333336,2021-01-30
397,875,24309,7382575,0.03599489900859764,145833.33333333334,42888666.66666667,2021-01-31
398,1840,44045,7426620,0.04177545691906005,306666.6666666667,43195333.333333336,2021-02-01
399,1221,29309,7455929,0.04165955849738988,203500.0,43398833.333333336,2021-02-02
400,1047,27735,7483664,0.03775013520822066,174500.0,43573333.333333336,2021-02-03
401,998,27643,7511307,0.03610317259342329,166333.33333333334,43739666.66666667,2021-02-04
402,1220,33777,7545084,0.03611925274595139,203333.33333333334,43943000.00000001,2021-02-05
403,1014,26592,7571676,0.03813176895306859,169000.0,44112000.00000001,2021-02-06
404,1070,26136,7597812,0.04093970003060912,178333.33333333334,44290333.33333334,2021-02-07
405,1300,35661,7633473,0.036454389949805106,216666.66666666666,44507000.00000001,2021-02-08
406,1185,29369,7662842,0.040348666961762404,197500.0,44704500.00000001,2021-02-09
407,1762,36475,7699317,0.048307059629883485,293666.6666666667,44998166.66666667,2021-02-10
408,1212,29589,7728906,0.04096116800162222,202000.0,45200166.66666667,2021-02-11
409,1511,35781,7764687,0.04222911601129091,251833.3333333333,45452000.00000001,2021-02-12
410,1333,30967,7795654,0.043045822972842054,222166.66666666666,45674166.66666667,2021-02-13
411,1510,32568,7828222,0.04636452959960698,251666.66666666666,45925833.333333336,2021-02-14
412,2028,46458,7874680,0.043652331137801884,338000.0,46263833.333333336,2021-02-15
413,1546,35868,7910548,0.0431024868963979,257666.66666666666,46521500.0,2021-02-16
414,1702,38615,7949163,0.04407613621649618,283666.6666666667,46805166.666666664,2021-02-17
415,2023,43886,7993049,0.046096705099576175,337166.6666666667,47142333.33333333,2021-02-18
416,1863,45590,8038639,0.040864224610660235,310500.0,47452833.33333333,2021-02-19
417,2631,50740,8089379,0.05185258178951518,438500.0,47891333.33333333,2021-02-20
418,1802,38193,8127572,0.047181420679182046,300333.3333333333,48191666.666666664,2021-02-21
419,2323,53007,8180579,0.04382440055087064,387166.6666666667,48578833.33333333,2021-02-22
420,1956,43394,8223973,0.04507535604000553,326000.0,48904833.33333333,2021-02-23
421,2079,42954,8266927,0.048400614610979185,346500.0,49251333.33333333,2021-02-24
422,2456,49289,8316216,0.04982856215382742,409333.3333333333,49660666.666666664,2021-02-25
423,2403,52807,8369023,0.04550533073266802,400500.0,50061166.666666664,2021-02-26
424,2216,45925,8414948,0.04825258573761568,369333.3333333333,50430500.0,2021-02-27
425,2976,54982,8469930,0.0541268051362264,496000.0,50926500.0,2021-02-28
426,4904,82231,8552161,0.059636876603713924,817333.3333333334,51743833.333333336,2021-03-01
427,2921,54449,8606610,0.05364653161674227,486833.3333333333,52230666.66666667,2021-03-02
428,2914,52557,8659167,0.05544456494853207,485666.6666666666,52716333.333333336,2021-03-03
429,2860,53242,8712409,0.05371699034596747,476666.6666666666,53193000.0,2021-03-04
430,3464,66165,8778574,0.05235396357590871,577333.3333333334,53770333.333333336,2021-03-05
431,2892,54134,8832708,0.05342298740163298,482000.0,54252333.333333336,2021-03-06
432,2962,51368,8884076,0.05766235788817941,493666.6666666666,54746000.0,2021-03-07
433,3718,70008,8954084,0.05310821620386241,619666.6666666666,55365666.666666664,2021-03-08
434,3152,57170,9011254,0.05513381143956621,525333.3333333334,55891000.0,2021-03-09
435,4606,69283,9080537,0.06648095492400734,767666.6666666666,56658666.666666664,2021-03-10
436,3062,54067,9134604,0.056633436292008066,510333.3333333333,57169000.0,2021-03-11
437,3443,64144,9198748,0.05367610376652532,573833.3333333334,57742833.333333336,2021-03-12
438,3104,54864,9253612,0.05657626130067075,517333.3333333333,58260166.66666667,2021-03-13
439,3109,52950,9306562,0.058715769593956565,518166.6666666666,58778333.333333336,2021-03-14
440,4111,73494,9380056,0.05593653903720031,685166.6666666666,59463500.0,2021-03-15
441,3085,53809,9433865,0.057332416510249215,514166.6666666666,59977666.666666664,2021-03-16
442,3032,51813,9485678,0.058518132515005886,505333.3333333333,60483000.0,2021-03-17
443,3260,55432,9541110,0.0588107952085438,543333.3333333334,61026333.333333336,2021-03-18
444,3190,59443,9600553,0.053664855407701495,531666.6666666666,61558000.0,2021-03-19
445,4097,63137,9663690,0.06489063465163059,682833.3333333334,62240833.333333336,2021-03-20
446,2623,44418,9708108,0.059052636318609575,437166.6666666667,62678000.0,2021-03-21
447,2922,58818,9766926,0.049678669794960724,487000.0,63165000.0,2021-03-22
448,2730,48025,9814951,0.05684539302446642,455000.0,63620000.0,2021-03-23
449,2522,44140,9859091,0.05713638423198913,420333.3333333333,64040333.333333336,2021-03-24
450,2977,49885,9908976,0.05967725769269319,496166.6666666666,64536500.0,2021-03-25
451,2571,48749,9957725,0.05273954337524872,428500.0,64965000.0,2021-03-26
452,2256,39211,9996936,0.0575348754176124,376000.0,65341000.0,2021-03-27
453,2391,37837,10034773,0.06319211353965695,398500.0,65739500.0,2021-03-28
454,2299,43275,10078048,0.05312536106296938,383166.6666666667,66122666.666666664,2021-03-29
455,2279,36838,10114886,0.06186546500895814,379833.3333333333,66502500.0,2021-03-30
456,2007,35639,10150525,0.05631471141165577,334500.0,66837000.0,2021-03-31
457,3572,55322,10205847,0.0645674415241676,595333.3333333334,67432333.33333333,2021-04-01
458,2222,39818,10245665,0.05580390778040083,370333.3333333333,67802666.66666666,2021-04-02
459,2071,37917,10283582,0.05461930005010945,345166.6666666667,68147833.33333333,2021-04-03
460,2123,38402,10321984,0.05528357898026144,353833.3333333333,68501666.66666666,2021-04-04
461,2436,49675,10371659,0.04903875188726724,406000.0,68907666.66666666,2021-04-05
462,1950,37652,10409311,0.051790077552321255,325000.0,69232666.66666666,2021-04-06
463,1850,35744,10445055,0.05175693822739481,308333.3333333333,69540999.99999999,2021-04-07
464,2011,38669,10483724,0.05200548242778453,335166.6666666667,69876166.66666666,2021-04-08
465,1994,41728,10525452,0.04778565950920245,332333.3333333333,70208499.99999999,2021-04-09
466,2614,44680,10570132,0.058504923903312446,435666.6666666667,70644166.66666666,2021-04-10
467,1644,32363,10602495,0.05079875166084726,274000.0,70918166.66666666,2021-04-11
468,1952,43724,10646219,0.04464367395480743,325333.3333333333,71243499.99999999,2021-04-12
469,1637,34426,10680645,0.04755126938941498,272833.3333333333,71516333.33333331,2021-04-13
470,1733,34535,10715180,0.05018097582163023,288833.3333333333,71805166.66666664,2021-04-14
471,1914,37731,10752911,0.050727518486125465,319000.0,72124166.66666664,2021-04-15
472,1655,37614,10790525,0.04399957462646887,275833.3333333333,72399999.99999997,2021-04-16
473,1427,31412,10821937,0.04542849866293137,237833.3333333333,72637833.3333333,2021-04-17
474,1528,31327,10853264,0.048775816388418936,254666.66666666666,72892499.99999997,2021-04-18
475,1614,40797,10894061,0.03956173248032944,269000.0,73161499.99999997,2021-04-19
476,2166,42841,10936902,0.05055904390653813,361000.0,73522499.99999997,2021-04-20
477,1370,29863,10966765,0.04587616783310451,228333.33333333334,73750833.3333333,2021-04-21
478,1496,35118,11001883,0.04259923685859104,249333.3333333333,74000166.66666663,2021-04-22
479,1542,38370,11040253,0.0401876465989054,257000.0,74257166.66666663,2021-04-23
480,1481,34731,11074984,0.0426420200973194,246833.3333333333,74503999.99999996,2021-04-24
481,1624,35744,11110728,0.04543419874664279,270666.6666666667,74774666.66666663,2021-04-25
482,1566,41328,11152056,0.03789198606271777,261000.0,75035666.66666663,2021-04-26
483,1468,33641,11185697,0.04363722838203383,244666.66666666666,75280333.3333333,2021-04-27
484,1575,33825,11219522,0.04656319290465632,262500.0,75542833.3333333,2021-04-28
485,1261,30629,11250151,0.04117013288060335,210166.66666666666,75752999.99999997,2021-04-29
486,1674,40980,11291131,0.040849194729136167,279000.0,76031999.99999997,2021-04-30
487,2372,46987,11338118,0.050482048226105095,395333.3333333333,76427333.3333333,2021-05-01
488,1519,35558,11373676,0.04271893807300748,253166.66666666666,76680499.99999997,2021-05-02
489,1671,44240,11417916,0.03777124773960217,278500.0,76958999.99999997,2021-05-03
490,1438,36773,11454689,0.039104777962091754,239666.66666666666,77198666.66666664,2021-05-04
491,1767,39650,11494339,0.04456494325346785,294500.0,77493166.66666664,2021-05-05
492,1483,36548,11530887,0.0405767757469629,247166.66666666666,77740333.33333331,2021-05-06
493,1572,41701,11572588,0.03769693772331599,262000.0,78002333.33333331,2021-05-07
494,1599,39691,11612279,0.040286210979819104,266500.0,78268833.33333331,2021-05-08
495,1587,39961,11652240,0.03971372087785591,264500.0,78533333.33333331,2021-05-09
496,2390,60166,11712406,0.03972343183857993,398333.3333333333,78931666.66666664,2021-05-10
497,1584,40521,11752927,0.039090841785740724,264000.0,79195666.66666664,2021-05-11
498,1683,41440,11794367,0.04061293436293436,280500.0,79476166.66666664,2021-05-12
499,1593,41508,11835875,0.038378143972246315,265500.0,79741666.66666664,2021-05-13
500,1784,49710,11885585,0.03588815127740897,297333.3333333333,80038999.99999997,2021-05-14
501,1927,51135,11936720,0.03768456047716828,321166.6666666667,80360166.66666664,2021-05-15
502,1605,42397,11979117,0.037856452107460435,267500.0,80627666.66666664,2021-05-16
503,1839,54498,12033615,0.03374435759110426,306500.0,80934166.66666664,2021-05-17
504,1763,47153,12080768,0.0373889254130172,293833.3333333333,81227999.99999997,2021-05-18
505,1495,44195,12124963,0.03382735603575065,249166.66666666666,81477166.66666664,2021-05-19
506,2313,55845,12180808,0.04141821112006446,385500.0,81862666.66666664,2021-05-20
507,1630,49398,12230206,0.0329972873395684,271666.6666666667,82134333.33333331,2021-05-21
508,1546,43944,12274150,0.03518113963225924,257666.66666666666,82391999.99999999,2021-05-22
509,1515,42419,12316569,0.035715127655060235,252500.0,82644499.99999999,2021-05-23
510,1761,55479,12372048,0.031741740117882444,293500.0,82937999.99999999,2021-05-24
511,1936,53694,12425742,0.03605617014936492,322666.6666666667,83260666.66666666,2021-05-25
512,1588,45167,12470909,0.03515841211503974,264666.6666666667,83525333.33333333,2021-05-26
513,1582,45081,12515990,0.035092389254896744,263666.6666666667,83789000.0,2021-05-27
514,1720,52299,12568289,0.032887818122717453,286666.6666666667,84075666.66666667,2021-05-28
515,1344,41215,12609504,0.03260948683731651,224000.0,84299666.66666667,2021-05-29
516,1449,39610,12649114,0.036581671295127495,241500.0,84541166.66666667,2021-05-30
517,1636,48945,12698059,0.033425273265910715,272666.6666666667,84813833.33333334,2021-05-31
518,2308,57431,12755490,0.040187355261095924,384666.6666666667,85198500.00000001,2021-06-01
519,1541,45892,12801382,0.03357883727011244,256833.3333333333,85455333.33333334,2021-06-02
520,1425,41077,12842459,0.03469094627163619,237500.0,85692833.33333334,2021-06-03
521,1535,48191,12890650,0.03185242057645619,255833.3333333333,85948666.66666667,2021-06-04
522,1365,44822,12935472,0.03045379501137834,227500.0,86176166.66666667,2021-06-05
523,1331,40661,12976133,0.03273406950148791,221833.33333333334,86398000.0,2021-06-06
524,1356,48488,13024621,0.027965682230655008,226000.0,86624000.0,2021-06-07
525,1235,39260,13063881,0.03145695364238411,205833.33333333334,86829833.33333333,2021-06-08
526,1208,37177,13101058,0.0324932081663394,201333.33333333334,87031166.66666666,2021-06-09
527,1596,44827,13145885,0.035603542507863566,266000.0,87297166.66666666,2021-06-10
528,1134,39461,13185346,0.028737234231266312,189000.0,87486166.66666666,2021-06-11
529,1117,35678,13221024,0.03130780873367341,186166.66666666666,87672333.33333333,2021-06-12
530,1050,32546,13253570,0.03226202912800344,175000.0,87847333.33333333,2021-06-13
531,1199,42774,13296344,0.028031046897648106,199833.33333333334,88047166.66666666,2021-06-14
532,1137,36258,13332602,0.031358596723481715,189500.0,88236666.66666666,2021-06-15
533,963,31756,13364358,0.030324977956921528,160500.0,88397166.66666666,2021-06-16
534,914,30932,13395290,0.029548687443424284,152333.33333333334,88549499.99999999,2021-06-17
535,1095,36693,13431983,0.029842204235140217,182500.0,88731999.99999999,2021-06-18
536,875,31187,13463170,0.028056562029050568,145833.33333333334,88877833.33333331,2021-06-19
537,1250,34827,13497997,0.03589169322651965,208333.33333333334,89086166.66666664,2021-06-20
538,892,33912,13531909,0.0263033734371314,148666.66666666666,89234833.33333331,2021-06-21
539,786,27769,13559678,0.028304944362418524,131000.0,89365833.33333331,2021-06-22
540,758,26213,13585891,0.028916949605157748,126333.33333333333,89492166.66666664,2021-06-23
541,790,25270,13611161,0.03126236644242184,131666.66666666666,89623833.33333331,2021-06-24
542,924,30216,13641377,0.03057982525814138,154000.0,89777833.33333331,2021-06-25
543,742,25086,13666463,0.02957825081718887,123666.66666666666,89901499.99999999,2021-06-26
544,618,21170,13687633,0.029192253188474255,103000.0,90004499.99999999,2021-06-27
545,816,28544,13716177,0.02858744394618834,136000.0,90140499.99999999,2021-06-28
546,548,20758,13736935,0.026399460448983524,91333.33333333333,90231833.33333331,2021-06-29
547,732,24111,13761046,0.03035958691053876,122000.0,90353833.33333331,2021-06-30
548,1123,30013,13791059,0.03741711924832573,187166.66666666666,90540999.99999999,2021-07-01
549,761,26524,13817583,0.028690996833056853,126833.33333333333,90667833.33333331,2021-07-02
550,675,22755,13840338,0.02966381015161503,112500.0,90780333.33333331,2021-07-03
551,698,21444,13861782,0.03254989740720015,116333.33333333333,90896666.66666664,2021-07-04
552,844,28757,13890539,0.029349375804152034,140666.66666666666,91037333.33333331,2021-07-05
553,638,21984,13912523,0.029021106259097526,106333.33333333333,91143666.66666664,2021-07-06
554,639,21607,13934130,0.029573749247928913,106500.0,91250166.66666664,2021-07-07
555,658,22109,13956239,0.029761635533040842,109666.66666666667,91359833.33333331,2021-07-08
556,587,24086,13980325,0.024371003902682056,97833.33333333333,91457666.66666664,2021-07-09
557,858,26336,14006661,0.03257897934386391,143000.0,91600666.66666664,2021-07-10
558,515,19329,14025990,0.026643902943763256,85833.33333333333,91686499.99999997,2021-07-11
559,642,26142,14052132,0.02455818223548313,107000.0,91793499.99999997,2021-07-12
560,512,20625,14072757,0.024824242424242426,85333.33333333333,91878833.3333333,2021-07-13
561,554,19167,14091924,0.028903845150519122,92333.33333333333,91971166.66666663,2021-07-14
562,656,20932,14112856,0.031339575769157274,109333.33333333333,92080499.99999996,2021-07-15
563,553,20497,14133353,0.026979557984095234,92166.66666666667,92172666.66666663,2021-07-16
564,516,18059,14151412,0.028573010687191983,86000.0,92258666.66666663,2021-07-17
565,525,17645,14169057,0.029753471238311135,87500.0,92346166.66666663,2021-07-18
566,589,22161,14191218,0.02657822300437706,98166.66666666667,92444333.3333333,2021-07-19
567,708,21150,14212368,0.03347517730496454,118000.0,92562333.3333333,2021-07-20
568,528,16167,14228535,0.03265912043050659,88000.0,92650333.3333333,2021-07-21
569,536,16471,14245006,0.03254204359176735,89333.33333333333,92739666.66666663,2021-07-22
570,529,18388,14263394,0.028768762236241027,88166.66666666667,92827833.3333333,2021-07-23
571,477,15335,14278729,0.031105314639713076,79500.0,92907333.3333333,2021-07-24
572,524,16595,14295324,0.03157577583609521,87333.33333333333,92994666.66666663,2021-07-25
573,488,18182,14313506,0.026839731602683974,81333.33333333333,93075999.99999996,2021-07-26
574,491,15224,14328730,0.032251707829742515,81833.33333333333,93157833.33333328,2021-07-27
575,476,14465,14343195,0.03290701693743519,79333.33333333333,93237166.66666661,2021-07-28
576,425,13193,14356388,0.03221405290684454,70833.33333333333,93307999.99999994,2021-07-29
577,512,15708,14372096,0.032594856124267886,85333.33333333333,93393333.33333327,2021-07-30
578,480,13520,14385616,0.03550295857988166,80000.0,93473333.33333327,2021-07-31
579,743,19079,14404695,0.038943340845956284,123833.33333333333,93597166.6666666,2021-08-01
580,535,18358,14423053,0.029142608127246977,89166.66666666667,93686333.33333327,2021-08-02
581,450,14725,14437778,0.030560271646859084,75000.0,93761333.33333327,2021-08-03
582,457,13586,14451364,0.03363756808479317,76166.66666666667,93837499.99999994,2021-08-04
583,494,14485,14465849,0.03410424577148775,82333.33333333333,93919833.33333327,2021-08-05
584,464,15252,14481101,0.03042223970626803,77333.33333333333,93997166.6666666,2021-08-06
585,376,12491,14493592,0.03010167320470739,62666.666666666664,94059833.33333327,2021-08-07
586,452,13364,14506956,0.03382220891948518,75333.33333333333,94135166.6666666,2021-08-08
587,465,16701,14523657,0.02784264415304473,77500.0,94212666.6666666,2021-08-09
588,591,16144,14539801,0.03660802775024777,98500.0,94311166.6666666,2021-08-10
589,340,11862,14551663,0.02866295734277525,56666.666666666664,94367833.33333327,2021-08-11
590,414,12866,14564529,0.03217783304834448,69000.0,94436833.33333327,2021-08-12
591,766,26893,14591422,0.028483248428959208,127666.66666666666,94564499.99999994,2021-08-13
