,cases,deaths,cases_cum,case_adj,case_adj_cum,date
0,7,0,7,0.0,0.0,2020-02-26
1,2,0,9,0.0,0.0,2020-02-27
2,2,0,11,0.0,0.0,2020-02-28
3,3,0,14,0.0,0.0,2020-02-29
4,3,0,17,0.0,0.0,2020-03-01
5,5,0,22,0.0,0.0,2020-03-02
6,2,0,24,0.0,0.0,2020-03-03
7,5,0,29,0.0,0.0,2020-03-04
8,2,0,31,0.0,0.0,2020-03-05
9,4,0,35,0.0,0.0,2020-03-06
10,1,0,36,0.0,0.0,2020-03-07
11,2,0,38,0.0,0.0,2020-03-08
12,2,0,40,0.0,0.0,2020-03-09
13,3,0,43,0.0,0.0,2020-03-10
14,1,0,44,0.0,0.0,2020-03-11
15,2,0,46,0.0,0.0,2020-03-12
16,3,0,49,0.0,0.0,2020-03-13
17,1,0,50,0.0,0.0,2020-03-14
18,1,0,51,0.0,0.0,2020-03-15
19,1,0,52,0.0,0.0,2020-03-16
20,2,0,54,0.0,0.0,2020-03-17
21,1,0,55,0.0,0.0,2020-03-18
22,2,0,57,0.0,0.0,2020-03-19
23,1,0,58,0.0,0.0,2020-03-20
24,2,0,60,0.0,0.0,2020-03-21
25,2,0,62,0.0,0.0,2020-03-22
26,1,0,63,0.0,0.0,2020-03-23
27,2,0,65,0.0,0.0,2020-03-24
28,2,0,67,0.0,0.0,2020-03-25
29,2,0,69,0.0,0.0,2020-03-26
30,1,0,70,0.0,0.0,2020-03-27
31,1,0,71,0.0,0.0,2020-03-28
32,5,2,76,333.3333333333333,666.6666666666666,2020-03-29
33,1,1,77,166.66666666666666,1000.0,2020-03-30
34,4,2,81,333.3333333333333,1666.6666666666665,2020-03-31
35,1,1,82,166.66666666666666,1999.9999999999998,2020-04-01
36,1,0,83,0.0,1999.9999999999998,2020-04-02
37,4,0,87,0.0,1999.9999999999998,2020-04-03
38,3,3,90,500.0,3000.0,2020-04-04
39,7,1,97,166.66666666666666,3333.3333333333335,2020-04-05
40,7,1,104,166.66666666666666,3666.666666666667,2020-04-06
41,2,0,106,0.0,3666.666666666667,2020-04-07
42,19,7,125,1166.6666666666667,6000.0,2020-04-08
43,70,3,195,500.0,7000.0,2020-04-09
44,85,5,280,833.3333333333334,8666.666666666666,2020-04-10
45,47,1,327,166.66666666666666,9000.0,2020-04-11
46,151,3,478,500.0,10000.0,2020-04-12
47,57,1,535,166.66666666666666,10333.333333333334,2020-04-13
48,41,0,576,0.0,10333.333333333334,2020-04-14
49,58,2,634,333.3333333333333,11000.0,2020-04-15
50,54,2,688,333.3333333333333,11666.666666666666,2020-04-16
51,268,3,956,500.0,12666.666666666666,2020-04-17
52,44,1,1000,166.66666666666666,13000.0,2020-04-18
53,77,3,1077,500.0,14000.0,2020-04-19
54,92,4,1169,666.6666666666666,15333.333333333334,2020-04-20
55,86,1,1255,166.66666666666666,15666.666666666668,2020-04-21
56,263,4,1518,666.6666666666666,17000.0,2020-04-22
57,143,12,1661,2000.0,21000.0,2020-04-23
58,120,3,1781,500.0,22000.0,2020-04-24
59,146,7,1927,1166.6666666666667,24333.333333333332,2020-04-25
60,136,10,2063,1666.6666666666667,27666.666666666664,2020-04-26
61,448,23,2511,3833.333333333333,35333.33333333333,2020-04-27
62,151,11,2662,1833.3333333333333,38999.99999999999,2020-04-28
63,160,13,2822,2166.6666666666665,43333.33333333333,2020-04-29
64,232,12,3054,2000.0,47333.33333333333,2020-04-30
65,177,11,3231,1833.3333333333333,50999.99999999999,2020-05-01
66,316,21,3547,3500.0,57999.99999999999,2020-05-02
67,232,23,3779,3833.333333333333,65666.66666666666,2020-05-03
68,261,16,4040,2666.6666666666665,70999.99999999999,2020-05-04
69,267,17,4307,2833.3333333333335,76666.66666666666,2020-05-05
70,259,19,4566,3166.6666666666665,82999.99999999999,2020-05-06
71,463,31,5029,5166.666666666667,93333.33333333331,2020-05-07
72,205,32,5234,5333.333333333333,103999.99999999999,2020-05-08
73,769,64,6003,10666.666666666666,125333.33333333331,2020-05-09
74,469,49,6472,8166.666666666666,141666.66666666666,2020-05-10
75,500,39,6972,6500.0,154666.66666666666,2020-05-11
76,503,48,7475,8000.0,170666.66666666666,2020-05-12
77,861,49,8336,8166.666666666666,187000.0,2020-05-13
78,616,67,8952,11166.666666666666,209333.33333333334,2020-05-14
79,600,60,9552,10000.0,229333.33333333334,2020-05-15
80,641,58,10193,9666.666666666666,248666.6666666667,2020-05-16
81,660,70,10853,11666.666666666666,272000.0,2020-05-17
82,1643,111,12496,18500.0,309000.0,2020-05-18
83,775,77,13271,12833.333333333334,334666.6666666667,2020-05-19
84,971,79,14242,13166.666666666666,361000.0,2020-05-20
85,1163,111,15405,18500.0,398000.0,2020-05-21
86,1153,108,16558,18000.0,434000.0,2020-05-22
87,2118,127,18676,21166.666666666668,476333.3333333333,2020-05-23
88,1281,121,19957,20166.666666666668,516666.6666666666,2020-05-24
89,1563,137,21520,22833.333333333332,562333.3333333333,2020-05-25
90,1729,161,23249,26833.333333333332,615999.9999999999,2020-05-26
91,1609,140,24858,23333.333333333332,662666.6666666665,2020-05-27
92,3739,292,28597,48666.666666666664,759999.9999999999,2020-05-28
93,1863,159,30460,26500.0,812999.9999999999,2020-05-29
94,2263,175,32723,29166.666666666664,871333.3333333333,2020-05-30
95,2328,195,35051,32500.0,936333.3333333333,2020-05-31
96,2786,273,37837,45500.0,1027333.3333333333,2020-06-01
97,3406,270,41243,45000.0,1117333.3333333333,2020-06-02
98,2840,243,44083,40500.0,1198333.3333333333,2020-06-03
99,3592,260,47675,43333.333333333336,1285000.0,2020-06-04
100,4065,309,51740,51500.0,1388000.0,2020-06-05
101,3355,243,55095,40500.0,1469000.0,2020-06-06
102,4991,324,60086,54000.0,1577000.0,2020-06-07
103,8506,567,68592,94500.0,1766000.0,2020-06-08
104,5382,385,73974,64166.666666666664,1894333.3333333333,2020-06-09
105,4962,326,78936,54333.333333333336,2003000.0,2020-06-10
106,6176,409,85112,68166.66666666667,2139333.3333333335,2020-06-11
107,8510,427,93622,71166.66666666667,2281666.666666667,2020-06-12
108,5684,344,99306,57333.333333333336,2396333.3333333335,2020-06-13
109,5851,327,105157,54500.0,2505333.3333333335,2020-06-14
110,7097,382,112254,63666.666666666664,2632666.666666667,2020-06-15
111,6219,358,118473,59666.666666666664,2752000.0000000005,2020-06-16
112,11886,613,130359,102166.66666666667,2956333.333333334,2020-06-17
113,7352,409,137711,68166.66666666667,3092666.6666666674,2020-06-18
114,7194,363,144905,60500.0,3213666.6666666674,2020-06-19
115,6339,326,151244,54333.333333333336,3322333.333333334,2020-06-20
116,6898,363,158142,60500.0,3443333.333333334,2020-06-21
117,11456,470,169598,78333.33333333333,3600000.0000000005,2020-06-22
118,6828,357,176426,59500.0,3719000.0000000005,2020-06-23
119,6555,303,182981,50500.0,3820000.0000000005,2020-06-24
120,9265,374,192246,62333.33333333333,3944666.666666667,2020-06-25
121,7117,323,199363,53833.333333333336,4052333.3333333335,2020-06-26
122,12800,490,212163,81666.66666666667,4215666.666666667,2020-06-27
123,7109,343,219272,57166.666666666664,4330000.0,2020-06-28
124,7662,305,226934,50833.333333333336,4431666.666666667,2020-06-29
125,6408,295,233342,49166.666666666664,4530000.0,2020-06-30
126,6169,291,239511,48500.0,4627000.0,2020-07-01
127,11450,427,250961,71166.66666666667,4769333.333333333,2020-07-02
128,7181,268,258142,44666.666666666664,4858666.666666666,2020-07-03
129,7189,285,265331,47500.0,4953666.666666666,2020-07-04
130,8797,312,274128,52000.0,5057666.666666666,2020-07-05
131,7657,306,281785,51000.0,5159666.666666666,2020-07-06
132,8099,253,289884,42166.666666666664,5243999.999999999,2020-07-07
133,5800,242,295684,40333.333333333336,5324666.666666666,2020-07-08
134,15379,523,311063,87166.66666666667,5498999.999999999,2020-07-09
135,8839,331,319902,55166.666666666664,5609333.333333332,2020-07-10
136,7797,312,327699,52000.0,5713333.333333332,2020-07-11
137,7423,298,335122,49666.666666666664,5812666.666666665,2020-07-12
138,10252,323,345374,53833.333333333336,5920333.333333332,2020-07-13
139,8410,275,353784,45833.333333333336,6011999.999999999,2020-07-14
140,7127,244,360911,40666.666666666664,6093333.333333332,2020-07-15
141,9996,274,370907,45666.666666666664,6184666.666666665,2020-07-16
142,8051,250,378958,41666.666666666664,6267999.999999998,2020-07-17
143,13733,418,392691,69666.66666666667,6407333.333333331,2020-07-18
144,7211,236,399902,39333.333333333336,6485999.999999998,2020-07-19
145,9391,259,409293,43166.666666666664,6572333.333333331,2020-07-20
146,7517,292,416810,48666.666666666664,6669666.666666664,2020-07-21
147,7682,265,424492,44166.666666666664,6757999.999999997,2020-07-22
148,13368,338,437860,56333.333333333336,6870666.666666664,2020-07-23
149,9316,275,447176,45833.333333333336,6962333.333333331,2020-07-24
150,8555,262,455731,43666.666666666664,7049666.666666664,2020-07-25
151,9340,280,465071,46666.666666666664,7142999.999999997,2020-07-26
152,8957,273,474028,45500.0,7233999.999999997,2020-07-27
153,13189,351,487217,58500.0,7350999.999999997,2020-07-28
154,6762,206,493979,34333.333333333336,7419666.666666664,2020-07-29
155,10496,263,504475,43833.333333333336,7507333.333333331,2020-07-30
156,8874,236,513349,39333.333333333336,7585999.999999998,2020-07-31
157,8500,230,521849,38333.333333333336,7662666.666666665,2020-08-01
158,10748,291,532597,48500.0,7759666.666666665,2020-08-02
159,10629,279,543226,46500.0,7852666.666666665,2020-08-03
160,7967,201,551193,33500.0,7919666.666666665,2020-08-04
161,8965,258,560158,43000.0,8005666.666666665,2020-08-05
162,10238,223,570396,37166.666666666664,8079999.999999998,2020-08-06
163,11388,308,581784,51333.333333333336,8182666.666666665,2020-08-07
164,16047,439,597831,73166.66666666667,8328999.999999998,2020-08-08
165,10348,264,608179,44000.0,8416999.999999998,2020-08-09
166,10473,270,618652,45000.0,8506999.999999998,2020-08-10
167,8449,262,627101,43666.666666666664,8594333.333333332,2020-08-11
168,9777,269,636878,44833.333333333336,8683999.999999998,2020-08-12
169,11532,280,648410,46666.666666666664,8777333.333333332,2020-08-13
170,10522,281,658932,46833.333333333336,8870999.999999998,2020-08-14
171,9961,278,668893,46333.333333333336,8963666.666666664,2020-08-15
172,9116,233,678009,38833.333333333336,9041333.33333333,2020-08-16
173,15237,389,693246,64833.33333333333,9170999.999999996,2020-08-17
174,7935,233,701181,38833.333333333336,9248666.666666662,2020-08-18
175,8361,264,709542,44000.0,9336666.666666662,2020-08-19
176,11132,223,720674,37166.666666666664,9410999.999999996,2020-08-20
177,9211,231,729885,38500.0,9487999.999999996,2020-08-21
178,11374,279,741259,46500.0,9580999.999999996,2020-08-22
179,8933,248,750192,41333.333333333336,9663666.666666662,2020-08-23
180,10466,222,760658,37000.0,9737666.666666662,2020-08-24
181,8745,247,769403,41166.666666666664,9819999.999999996,2020-08-25
182,8014,226,777417,37666.666666666664,9895333.33333333,2020-08-26
183,15673,337,793090,56166.666666666664,10007666.666666664,2020-08-27
184,8817,189,801907,31500.0,10070666.666666664,2020-08-28
185,8598,196,810505,32666.666666666664,10135999.999999998,2020-08-29
186,8901,193,819406,32166.666666666664,10200333.333333332,2020-08-30
187,8983,200,828389,33333.333333333336,10266999.999999998,2020-08-31
188,9480,223,837869,37166.666666666664,10341333.333333332,2020-09-01
189,7379,197,845248,32833.333333333336,10406999.999999998,2020-09-02
190,11073,204,856321,34000.0,10474999.999999998,2020-09-03
191,8644,194,864965,32333.333333333332,10539666.666666664,2020-09-04
192,7704,166,872669,27666.666666666668,10594999.999999998,2020-09-05
193,9079,180,881748,30000.0,10654999.999999998,2020-09-06
194,8013,178,889761,29666.666666666664,10714333.333333332,2020-09-07
195,12410,277,902171,46166.666666666664,10806666.666666666,2020-09-08
196,7654,181,909825,30166.666666666664,10867000.0,2020-09-09
197,9811,183,919636,30500.0,10928000.0,2020-09-10
198,8090,187,927726,31166.666666666664,10990333.333333334,2020-09-11
199,8619,168,936345,28000.0,11046333.333333334,2020-09-12
200,7835,173,944180,28833.333333333332,11104000.0,2020-09-13
201,8595,171,952775,28500.0,11161000.0,2020-09-14
202,7690,201,960465,33500.0,11228000.0,2020-09-15
203,6787,135,967252,22500.0,11273000.0,2020-09-16
204,13181,300,980433,50000.0,11373000.0,2020-09-17
205,7551,149,987984,24833.333333333332,11422666.666666666,2020-09-18
206,8114,179,996098,29833.333333333332,11482333.333333332,2020-09-19
207,7244,159,1003342,26500.0,11535333.333333332,2020-09-20
208,8559,144,1011901,24000.0,11583333.333333332,2020-09-21
209,7955,203,1019856,33833.333333333336,11650999.999999998,2020-09-22
210,6080,146,1025936,24333.333333333332,11699666.666666664,2020-09-23
211,8885,154,1034821,25666.666666666668,11750999.999999998,2020-09-24
212,8156,155,1042977,25833.333333333332,11802666.666666664,2020-09-25
213,6743,153,1049720,25500.0,11853666.666666664,2020-09-26
214,9816,232,1059536,38666.666666666664,11930999.999999998,2020-09-27
215,7077,137,1066613,22833.333333333332,11976666.666666664,2020-09-28
216,5592,112,1072205,18666.666666666668,12013999.999999998,2020-09-29
217,5114,125,1077319,20833.333333333332,12055666.666666664,2020-09-30
218,6904,142,1084223,23666.666666666668,12102999.999999998,2020-10-01
219,7173,152,1091396,25333.333333333332,12153666.666666664,2020-10-02
220,5628,133,1097024,22166.666666666668,12197999.999999998,2020-10-03
221,5545,115,1102569,19166.666666666668,12236333.333333332,2020-10-04
222,7095,145,1109664,24166.666666666668,12284666.666666666,2020-10-05
223,4116,107,1113780,17833.333333333332,12320333.333333332,2020-10-06
224,4901,122,1118681,20333.333333333332,12360999.999999998,2020-10-07
225,5964,130,1124645,21666.666666666668,12404333.333333332,2020-10-08
226,8716,212,1133361,35333.333333333336,12474999.999999998,2020-10-09
227,5442,131,1138803,21833.333333333332,12518666.666666664,2020-10-10
228,5011,105,1143814,17500.0,12553666.666666664,2020-10-11
229,5245,105,1149059,17500.0,12588666.666666664,2020-10-12
230,4894,124,1153953,20666.666666666668,12629999.999999998,2020-10-13
231,3842,107,1157795,17833.333333333332,12665666.666666664,2020-10-14
232,4714,127,1162509,21166.666666666668,12707999.999999998,2020-10-15
233,5591,120,1168100,20000.0,12747999.999999998,2020-10-16
234,5039,120,1173139,20000.0,12787999.999999998,2020-10-17
235,7038,165,1180177,27500.0,12842999.999999998,2020-10-18
236,5009,109,1185186,18166.666666666668,12879333.333333332,2020-10-19
237,4406,114,1189592,19000.0,12917333.333333332,2020-10-20
238,4010,100,1193602,16666.666666666668,12950666.666666666,2020-10-21
239,5832,96,1199434,16000.0,12982666.666666666,2020-10-22
240,5919,118,1205353,19666.666666666668,13022000.0,2020-10-23
241,4625,79,1209978,13166.666666666666,13048333.333333334,2020-10-24
242,4647,121,1214625,20166.666666666668,13088666.666666668,2020-10-25
243,5458,131,1220083,21833.333333333332,13132333.333333334,2020-10-26
244,3988,99,1224071,16500.0,13165333.333333334,2020-10-27
245,5949,148,1230020,24666.666666666668,13214666.666666668,2020-10-28
246,5084,90,1235104,15000.0,13244666.666666668,2020-10-29
247,4458,94,1239562,15666.666666666666,13276000.000000002,2020-10-30
248,4157,78,1243719,13000.0,13302000.000000002,2020-10-31
249,4261,70,1247980,11666.666666666666,13325333.333333336,2020-11-01
250,5622,132,1253602,22000.0,13369333.333333336,2020-11-02
251,3371,70,1256973,11666.666666666666,13392666.66666667,2020-11-03
252,3219,68,1260192,11333.333333333334,13415333.333333336,2020-11-04
253,5133,99,1265325,16500.0,13448333.333333336,2020-11-05
254,3952,96,1269277,16000.0,13480333.333333336,2020-11-06
255,4297,90,1273574,15000.0,13510333.333333336,2020-11-07
256,6371,149,1279945,24833.333333333332,13560000.000000002,2020-11-08
257,4242,82,1284187,13666.666666666666,13587333.333333336,2020-11-09
258,3147,74,1287334,12333.333333333334,13612000.000000002,2020-11-10
259,3010,72,1290344,12000.0,13636000.000000002,2020-11-11
260,4743,89,1295087,14833.333333333332,13665666.666666668,2020-11-12
261,3919,86,1299006,14333.333333333334,13694333.333333334,2020-11-13
262,3734,78,1302740,13000.0,13720333.333333334,2020-11-14
263,4002,87,1306742,14500.0,13749333.333333334,2020-11-15
264,4192,93,1310934,15500.0,13780333.333333334,2020-11-16
265,5210,126,1316144,21000.0,13822333.333333334,2020-11-17
266,2902,62,1319046,10333.333333333334,13843000.0,2020-11-18
267,3917,70,1322963,11666.666666666666,13866333.333333334,2020-11-19
268,4653,83,1327616,13833.333333333334,13894000.0,2020-11-20
269,4127,75,1331743,12500.0,13919000.0,2020-11-21
270,5082,95,1336825,15833.333333333332,13950666.666666666,2020-11-22
271,4547,81,1341372,13500.0,13977666.666666666,2020-11-23
272,3651,75,1345023,12500.0,14002666.666666666,2020-11-24
273,3861,89,1348884,14833.333333333332,14032333.333333332,2020-11-25
274,4936,95,1353820,15833.333333333332,14063999.999999998,2020-11-26
275,5850,114,1359670,19000.0,14101999.999999998,2020-11-27
276,3757,83,1363427,13833.333333333334,14129666.666666664,2020-11-28
277,3903,78,1367330,13000.0,14155666.666666664,2020-11-29
278,4234,74,1371564,12333.333333333334,14180333.33333333,2020-11-30
279,3161,62,1374725,10333.333333333334,14200999.999999996,2020-12-01
280,3652,96,1378377,16000.0,14232999.999999996,2020-12-02
281,4207,73,1382584,12166.666666666666,14257333.33333333,2020-12-03
282,3618,78,1386202,13000.0,14283333.33333333,2020-12-04
283,3670,85,1389872,14166.666666666666,14311666.666666664,2020-12-05
284,3703,73,1393575,12166.666666666666,14335999.999999998,2020-12-06
285,3836,77,1397411,12833.333333333334,14361666.666666664,2020-12-07
286,2661,57,1400072,9500.0,14380666.666666664,2020-12-08
287,5061,143,1405133,23833.333333333332,14428333.33333333,2020-12-09
288,3792,96,1408925,16000.0,14460333.33333333,2020-12-10
289,4361,78,1413286,13000.0,14486333.33333333,2020-12-11
290,3800,73,1417086,12166.666666666666,14510666.666666664,2020-12-12
291,4241,105,1421327,17500.0,14545666.666666664,2020-12-13
292,3966,78,1425293,13000.0,14571666.666666664,2020-12-14
293,3313,78,1428606,13000.0,14597666.666666664,2020-12-15
294,3402,102,1432008,17000.0,14631666.666666664,2020-12-16
295,4815,92,1436823,15333.333333333332,14662333.33333333,2020-12-17
296,6038,139,1442861,23166.666666666668,14708666.666666664,2020-12-18
297,4169,98,1447030,16333.333333333332,14741333.33333333,2020-12-19
298,4343,92,1451373,15333.333333333332,14771999.999999996,2020-12-20
299,5137,108,1456510,18000.0,14807999.999999996,2020-12-21
300,4565,105,1461075,17500.0,14842999.999999996,2020-12-22
301,6335,152,1467410,25333.333333333332,14893666.666666662,2020-12-23
302,7354,131,1474764,21833.333333333332,14937333.333333328,2020-12-24
303,6929,130,1481693,21666.666666666668,14980666.666666662,2020-12-25
304,7228,128,1488921,21333.333333333332,15023333.333333328,2020-12-26
305,7186,135,1496107,22500.0,15068333.333333328,2020-12-27
306,10990,206,1507097,34333.333333333336,15136999.999999994,2020-12-28
307,6350,110,1513447,18333.333333333332,15173666.66666666,2020-12-29
308,6667,138,1520114,23000.0,15219666.66666666,2020-12-30
309,9386,148,1529500,24666.666666666668,15268999.999999994,2020-12-31
310,7276,136,1536776,22666.666666666668,15314333.333333328,2021-01-01
311,8398,168,1545174,28000.0,15370333.333333328,2021-01-02
312,7403,131,1552577,21833.333333333332,15413999.999999994,2021-01-03
313,8029,148,1560606,24666.666666666668,15463333.333333328,2021-01-04
314,7215,136,1567821,22666.666666666668,15508666.666666662,2021-01-05
315,6373,121,1574194,20166.666666666668,15548999.999999996,2021-01-06
316,10401,221,1584595,36833.333333333336,15622666.666666662,2021-01-07
317,11547,276,1596142,46000.0,15714666.666666662,2021-01-08
318,7848,190,1603990,31666.666666666664,15777999.999999996,2021-01-09
319,7544,153,1611534,25500.0,15828999.999999996,2021-01-10
320,8218,159,1619752,26500.0,15881999.999999996,2021-01-11
321,7454,157,1627206,26166.666666666668,15934333.33333333,2021-01-12
322,6492,144,1633698,24000.0,15982333.33333333,2021-01-13
323,8915,191,1642613,31833.333333333332,16045999.999999996,2021-01-14
324,7949,185,1650562,30833.333333333332,16107666.666666662,2021-01-15
325,7552,172,1658114,28666.666666666668,16164999.999999996,2021-01-16
326,9681,241,1667795,40166.666666666664,16245333.33333333,2021-01-17
327,7941,148,1675736,24666.666666666668,16294666.666666664,2021-01-18
328,7150,127,1682886,21166.666666666668,16336999.999999998,2021-01-19
329,6049,151,1688935,25166.666666666668,16387333.333333332,2021-01-20
330,8320,188,1697255,31333.333333333332,16449999.999999998,2021-01-21
331,7679,192,1704934,32000.0,16513999.999999998,2021-01-22
332,6340,139,1711274,23166.666666666668,16560333.333333332,2021-01-23
333,6782,146,1718056,24333.333333333332,16608999.999999998,2021-01-24
334,7566,168,1725622,28000.0,16664999.999999998,2021-01-25
335,5187,139,1730809,23166.666666666668,16711333.333333332,2021-01-26
336,6909,221,1737718,36833.333333333336,16785000.0,2021-01-27
337,6332,133,1744050,22166.666666666668,16829333.333333332,2021-01-28
338,5797,156,1749847,26000.0,16881333.333333332,2021-01-29
339,6394,159,1756241,26500.0,16934333.333333332,2021-01-30
340,6209,171,1762450,28500.0,16991333.333333332,2021-01-31
341,6813,177,1769263,29500.0,17050333.333333332,2021-02-01
342,6485,158,1775748,26333.333333333332,17103000.0,2021-02-02
343,5863,167,1781611,27833.333333333332,17158666.666666668,2021-02-03
344,7856,193,1789467,32166.666666666664,17223000.0,2021-02-04
345,5702,152,1795169,25333.333333333332,17273666.666666668,2021-02-05
346,6952,172,1802121,28666.666666666668,17331000.0,2021-02-06
347,7213,172,1809334,28666.666666666668,17388333.333333332,2021-02-07
348,13032,392,1822366,65333.33333333333,17519000.0,2021-02-08
349,9580,226,1831946,37666.666666666664,17594333.333333332,2021-02-09
350,9472,215,1841418,35833.333333333336,17666000.0,2021-02-10
351,11378,241,1852796,40166.666666666664,17746333.333333332,2021-02-11
352,10588,264,1863384,44000.0,17834333.333333332,2021-02-12
353,8630,193,1872014,32166.666666666664,17898666.666666664,2021-02-13
354,8691,238,1880705,39666.666666666664,17977999.999999996,2021-02-14
355,10086,254,1890791,42333.333333333336,18062666.666666664,2021-02-15
356,8726,213,1899517,35500.0,18133666.666666664,2021-02-16
357,11360,377,1910877,62833.33333333333,18259333.333333332,2021-02-17
358,10093,219,1920970,36500.0,18332333.333333332,2021-02-18
359,8751,192,1929721,32000.0,18396333.333333332,2021-02-19
360,8007,200,1937728,33333.333333333336,18463000.0,2021-02-20
361,8370,234,1946098,39000.0,18541000.0,2021-02-21
362,10948,298,1957046,49666.666666666664,18640333.333333332,2021-02-22
363,7657,215,1964703,35833.333333333336,18712000.0,2021-02-23
364,7568,177,1972271,29500.0,18771000.0,2021-02-24
365,10222,260,1982493,43333.333333333336,18857666.666666668,2021-02-25
366,8145,185,1990638,30833.333333333332,18919333.333333336,2021-02-26
367,10678,319,2001316,53166.666666666664,19025666.666666668,2021-02-27
368,8058,188,2009374,31333.333333333332,19088333.333333336,2021-02-28
369,8448,206,2017822,34333.333333333336,19157000.000000004,2021-03-01
370,6920,196,2024742,32666.666666666664,19222333.333333336,2021-03-02
371,6890,234,2031632,39000.0,19300333.333333336,2021-03-03
372,10645,288,2042277,48000.0,19396333.333333336,2021-03-04
373,7552,190,2049829,31666.666666666664,19459666.666666668,2021-03-05
374,7464,212,2057293,35333.333333333336,19530333.333333336,2021-03-06
375,8416,229,2065709,38166.666666666664,19606666.666666668,2021-03-07
376,7520,178,2073229,29666.666666666664,19666000.0,2021-03-08
377,6851,178,2080080,29666.666666666664,19725333.333333332,2021-03-09
378,6629,197,2086709,32833.333333333336,19791000.0,2021-03-10
379,13502,491,2100211,81833.33333333333,19954666.666666668,2021-03-11
380,8614,323,2108825,53833.333333333336,20062333.333333336,2021-03-12
381,7865,235,2116690,39166.666666666664,20140666.666666668,2021-03-13
382,7863,266,2124553,44333.333333333336,20229333.333333336,2021-03-14
383,9482,283,2134035,47166.666666666664,20323666.666666668,2021-03-15
384,6955,216,2140990,36000.0,20395666.666666668,2021-03-16
385,6845,239,2147835,39833.333333333336,20475333.333333336,2021-03-17
386,9843,285,2157678,47500.0,20570333.333333336,2021-03-18
387,7869,264,2165547,44000.0,20658333.333333336,2021-03-19
388,10959,415,2176506,69166.66666666667,20796666.666666668,2021-03-20
389,7544,240,2184050,40000.0,20876666.666666668,2021-03-21
390,9468,287,2193518,47833.333333333336,20972333.333333336,2021-03-22
391,7819,252,2201337,42000.0,21056333.333333336,2021-03-23
392,8168,310,2209505,51666.666666666664,21159666.666666668,2021-03-24
393,12381,402,2221886,67000.0,21293666.666666668,2021-03-25
394,8987,293,2230873,48833.333333333336,21391333.333333336,2021-03-26
395,9653,322,2240526,53666.666666666664,21498666.666666668,2021-03-27
396,11290,406,2251816,67666.66666666667,21634000.0,2021-03-28
397,11358,355,2263174,59166.666666666664,21752333.333333332,2021-03-29
398,13616,552,2276790,92000.0,21936333.333333332,2021-03-30
399,9349,338,2286139,56333.333333333336,22049000.0,2021-03-31
400,13168,444,2299307,74000.0,22197000.0,2021-04-01
401,10427,353,2309734,58833.33333333333,22314666.666666668,2021-04-02
402,10467,383,2320201,63833.33333333333,22442333.333333336,2021-04-03
403,12731,468,2332932,78000.0,22598333.333333336,2021-04-04
404,13206,497,2346138,82833.33333333333,22764000.000000004,2021-04-05
405,11487,448,2357625,74666.66666666667,22913333.333333336,2021-04-06
406,14259,580,2371884,96666.66666666667,23106666.666666668,2021-04-07
407,22354,931,2394238,155166.66666666666,23417000.0,2021-04-08
408,14223,584,2408461,97333.33333333333,23611666.666666668,2021-04-09
409,13858,496,2422319,82666.66666666667,23777000.0,2021-04-10
410,13580,532,2435899,88666.66666666667,23954333.333333332,2021-04-11
411,17081,670,2452980,111666.66666666667,24177666.666666664,2021-04-12
412,13377,537,2466357,89500.0,24356666.666666664,2021-04-13
413,12822,548,2479179,91333.33333333333,24539333.333333332,2021-04-14
414,17707,674,2496886,112333.33333333333,24764000.0,2021-04-15
415,14670,587,2511556,97833.33333333333,24959666.666666668,2021-04-16
416,19173,932,2530729,155333.33333333334,25270333.333333336,2021-04-17
417,13428,560,2544157,93333.33333333333,25457000.000000004,2021-04-18
418,16617,604,2560774,100666.66666666667,25658333.333333336,2021-04-19
419,13773,572,2574547,95333.33333333333,25849000.000000004,2021-04-20
420,13319,553,2587866,92166.66666666667,26033333.333333336,2021-04-21
421,19734,755,2607600,125833.33333333333,26285000.000000004,2021-04-22
422,13756,546,2621356,91000.0,26467000.000000004,2021-04-23
423,13690,574,2635046,95666.66666666667,26658333.333333336,2021-04-24
424,14826,583,2649872,97166.66666666667,26852666.666666668,2021-04-25
425,15554,633,2665426,105500.0,27063666.666666668,2021-04-26
426,18217,831,2683643,138500.0,27340666.666666668,2021-04-27
427,11414,506,2695057,84333.33333333333,27509333.333333336,2021-04-28
428,15949,586,2711006,97666.66666666667,27704666.666666668,2021-04-29
429,12902,513,2723908,85500.0,27875666.666666668,2021-04-30
430,12301,536,2736209,89333.33333333333,28054333.333333336,2021-05-01
431,14302,665,2750511,110833.33333333333,28276000.000000004,2021-05-02
432,13720,524,2764231,87333.33333333333,28450666.66666667,2021-05-03
433,10717,456,2774948,76000.0,28602666.66666667,2021-05-04
434,11121,513,2786069,85500.0,28773666.66666667,2021-05-05
435,12915,516,2798984,86000.0,28945666.66666667,2021-05-06
436,11395,479,2810379,79833.33333333333,29105333.33333334,2021-05-07
437,10643,412,2821022,68666.66666666667,29242666.66666667,2021-05-08
438,17765,792,2838787,132000.0,29506666.66666667,2021-05-09
439,12718,513,2851505,85500.0,29677666.66666667,2021-05-10
440,11923,493,2863428,82166.66666666667,29842000.000000004,2021-05-11
441,12250,483,2875678,80500.0,30003000.000000004,2021-05-12
442,15934,538,2891612,89666.66666666667,30182333.333333336,2021-05-13
443,12005,439,2903617,73166.66666666667,30328666.666666668,2021-05-14
444,10993,439,2914610,73166.66666666667,30475000.0,2021-05-15
445,12389,445,2926999,74166.66666666667,30623333.333333332,2021-05-16
446,13373,478,2940372,79666.66666666667,30782666.666666664,2021-05-17
447,15204,658,2955576,109666.66666666667,31001999.999999996,2021-05-18
448,10029,391,2965605,65166.666666666664,31132333.33333333,2021-05-19
449,13687,421,2979292,70166.66666666667,31272666.66666666,2021-05-20
450,10689,360,2989981,60000.0,31392666.66666666,2021-05-21
451,10858,377,3000839,62833.33333333333,31518333.33333333,2021-05-22
452,12488,476,3013327,79333.33333333333,31676999.999999996,2021-05-23
453,12113,392,3025440,65333.33333333333,31807666.666666664,2021-05-24
454,9952,315,3035392,52500.0,31912666.666666664,2021-05-25
455,10439,367,3045831,61166.666666666664,32034999.999999996,2021-05-26
456,13306,372,3059137,62000.0,32158999.999999996,2021-05-27
457,14467,529,3073604,88166.66666666667,32335333.33333333,2021-05-28
458,9267,297,3082871,49500.0,32434333.33333333,2021-05-29
459,11474,370,3094345,61666.666666666664,32557666.66666666,2021-05-30
460,12633,340,3106978,56666.666666666664,32670999.999999993,2021-05-31
461,11498,339,3118476,56500.0,32783999.999999993,2021-06-01
462,12083,406,3130559,67666.66666666667,32919333.333333325,2021-06-02
463,13572,325,3144131,54166.666666666664,33027666.666666657,2021-06-03
464,10986,351,3155117,58500.0,33144666.666666657,2021-06-04
465,11194,350,3166311,58333.33333333333,33261333.333333325,2021-06-05
466,10141,303,3176452,50500.0,33362333.333333325,2021-06-06
467,13746,395,3190198,65833.33333333333,33493999.999999993,2021-06-07
468,16230,574,3206428,95666.66666666667,33685333.33333333,2021-06-08
469,11696,347,3218124,57833.333333333336,33800999.99999999,2021-06-09
470,14287,350,3232411,58333.33333333333,33917666.66666666,2021-06-10
471,11953,319,3244364,53166.666666666664,34023999.99999999,2021-06-11
472,13223,410,3257587,68333.33333333333,34160666.66666666,2021-06-12
473,12170,335,3269757,55833.333333333336,34272333.33333332,2021-06-13
474,13752,336,3283509,56000.0,34384333.33333332,2021-06-14
475,13354,357,3296863,59500.0,34503333.33333332,2021-06-15
476,13316,361,3310179,60166.666666666664,34623666.66666666,2021-06-16
477,20814,598,3330993,99666.66666666667,34822999.99999999,2021-06-17
478,13598,371,3344591,61833.33333333333,34946666.66666666,2021-06-18
479,13682,404,3358273,67333.33333333333,35081333.33333332,2021-06-19
480,13634,386,3371907,64333.33333333333,35209999.999999985,2021-06-20
481,16272,358,3388179,59666.666666666664,35329333.33333332,2021-06-21
482,17213,460,3405392,76666.66666666667,35482666.66666666,2021-06-22
483,14063,345,3419455,57500.0,35597666.66666666,2021-06-23
484,18027,429,3437482,71500.0,35740666.66666666,2021-06-24
485,15495,360,3452977,60000.0,35860666.66666666,2021-06-25
486,14928,319,3467905,53166.666666666664,35966999.99999999,2021-06-26
487,19448,536,3487353,89333.33333333333,36145666.66666666,2021-06-27
488,16027,337,3503380,56166.666666666664,36257999.99999999,2021-06-28
489,14308,332,3517688,55333.333333333336,36368666.66666666,2021-06-29
490,13202,307,3530890,51166.666666666664,36470999.99999999,2021-06-30
491,17281,365,3548171,60833.33333333333,36592666.66666666,2021-07-01
492,16804,439,3564975,73166.66666666667,36738999.99999999,2021-07-02
493,13388,328,3578363,54666.666666666664,36848333.33333333,2021-07-03
494,13128,346,3591491,57666.666666666664,36963666.666666664,2021-07-04
495,15457,340,3606948,56666.666666666664,37077000.0,2021-07-05
496,11601,260,3618549,43333.333333333336,37163666.666666664,2021-07-06
497,11536,297,3630085,49500.0,37262666.666666664,2021-07-07
498,13914,336,3643999,56000.0,37374666.666666664,2021-07-08
499,17470,513,3661469,85500.0,37545666.666666664,2021-07-09
500,13091,335,3674560,55833.333333333336,37657333.33333333,2021-07-10
501,12082,285,3686642,47500.0,37752333.33333333,2021-07-11
502,14065,327,3700707,54500.0,37861333.33333333,2021-07-12
503,13090,299,3713797,49833.333333333336,37960999.99999999,2021-07-13
504,11474,282,3725271,47000.0,38054999.99999999,2021-07-14
505,13816,272,3739087,45333.333333333336,38145666.66666666,2021-07-15
506,11156,267,3750243,44500.0,38234666.66666666,2021-07-16
507,10648,256,3760891,42666.666666666664,38319999.99999999,2021-07-17
508,13738,364,3774629,60666.666666666664,38441333.33333333,2021-07-18
509,11257,224,3785886,37333.333333333336,38515999.99999999,2021-07-19
510,10348,222,3796234,37000.0,38589999.99999999,2021-07-20
511,9383,215,3805617,35833.333333333336,38661666.66666666,2021-07-21
512,12074,240,3817691,40000.0,38741666.66666666,2021-07-22
513,10115,252,3827806,42000.0,38825666.66666666,2021-07-23
514,8781,195,3836587,32500.0,38890666.66666666,2021-07-24
515,8803,196,3845390,32666.666666666664,38955999.99999999,2021-07-25
516,10264,224,3855654,37333.333333333336,39030666.66666666,2021-07-26
517,8434,168,3864088,28000.0,39086666.66666666,2021-07-27
518,9442,267,3873530,44500.0,39175666.66666666,2021-07-28
519,8668,195,3882198,32500.0,39240666.66666666,2021-07-29
520,7436,141,3889634,23500.0,39287666.66666666,2021-07-30
521,7054,129,3896688,21500.0,39330666.66666666,2021-07-31
522,6850,147,3903538,24500.0,39379666.66666666,2021-08-01
523,8581,197,3912119,32833.333333333336,39445333.33333332,2021-08-02
524,7372,168,3919491,28000.0,39501333.33333332,2021-08-03
525,6052,130,3925543,21666.666666666668,39544666.66666666,2021-08-04
526,8183,181,3933726,30166.666666666664,39604999.99999999,2021-08-05
527,5837,121,3939563,20166.666666666668,39645333.33333333,2021-08-06
528,6760,150,3946323,25000.0,39695333.33333333,2021-08-07
529,8681,237,3955004,39500.0,39774333.33333333,2021-08-08
530,7225,158,3962229,26333.333333333332,39826999.99999999,2021-08-09
531,6389,143,3968618,23833.333333333332,39874666.66666666,2021-08-10
532,5829,126,3974447,21000.0,39916666.66666666,2021-08-11
533,7863,155,3982310,25833.333333333332,39968333.33333332,2021-08-12
534,5991,106,3988301,17666.666666666668,40003666.66666666,2021-08-13
535,5698,122,3993999,20333.333333333332,40044333.33333332,2021-08-14
536,5974,123,3999973,20500.0,40085333.33333332,2021-08-15
537,6512,118,4006485,19666.666666666668,40124666.66666666,2021-08-16
538,7549,191,4014034,31833.333333333332,40188333.33333332,2021-08-17
539,5126,79,4019160,13166.666666666666,40214666.66666666,2021-08-18
540,6957,112,4026117,18666.666666666668,40251999.99999999,2021-08-19
541,5232,96,4031349,16000.0,40283999.99999999,2021-08-20
542,4930,104,4036279,17333.333333333332,40318666.66666666,2021-08-21
543,5717,125,4041996,20833.333333333332,40360333.33333332,2021-08-22
544,5522,79,4047518,13166.666666666666,40386666.66666666,2021-08-23
545,4790,94,4052308,15666.666666666666,40417999.99999999,2021-08-24
546,4578,100,4056886,16666.666666666668,40451333.33333333,2021-08-25
547,5853,103,4062739,17166.666666666668,40485666.666666664,2021-08-26
548,5533,135,4068272,22500.0,40530666.666666664,2021-08-27
549,3925,84,4072197,14000.0,40558666.666666664,2021-08-28
550,3960,91,4076157,15166.666666666666,40589000.0,2021-08-29
551,4310,76,4080467,12666.666666666666,40614333.333333336,2021-08-30
552,3587,73,4084054,12166.666666666666,40638666.66666667,2021-08-31
553,4022,81,4088076,13500.0,40665666.66666667,2021-09-01
554,4136,73,4092212,12166.666666666666,40690000.00000001,2021-09-02
555,3403,77,4095615,12833.333333333334,40715666.66666667,2021-09-03
556,3265,55,4098880,9166.666666666666,40734000.00000001,2021-09-04
557,3113,70,4101993,11666.666666666666,40757333.33333334,2021-09-05
558,3497,70,4105490,11666.666666666666,40780666.66666668,2021-09-06
559,2804,57,4108294,9500.0,40799666.66666668,2021-09-07
560,4175,100,4112469,16666.666666666668,40833000.000000015,2021-09-08
561,3580,85,4116049,14166.666666666666,40861333.33333335,2021-09-09
562,2836,62,4118885,10333.333333333334,40882000.000000015,2021-09-10
563,2638,70,4121523,11666.666666666666,40905333.33333335,2021-09-11
564,2906,76,4124429,12666.666666666666,40930666.66666669,2021-09-12
565,3184,57,4127613,9500.0,40949666.66666669,2021-09-13
566,2577,54,4130190,9000.0,40967666.66666669,2021-09-14
567,2781,62,4132971,10333.333333333334,40988333.33333335,2021-09-15
568,3320,61,4136291,10166.666666666666,41008666.66666669,2021-09-16
569,3381,73,4139672,12166.666666666666,41033000.00000002,2021-09-17
570,2266,30,4141938,5000.0,41043000.00000002,2021-09-18
571,2571,37,4144509,6166.666666666667,41055333.33333336,2021-09-19
572,5513,99,4150022,16500.0,41088333.33333336,2021-09-20
