t,deaths,cases,cases_cum,nCFR,case_adj,cases_adj_cum,date
50,0,1,1,0.0,0.0,0.0,2020-02-19
51,2,5,6,0.4,333.3333333333333,333.3333333333333,2020-02-20
52,1,1,7,1.0,166.66666666666666,500.0,2020-02-21
53,2,4,11,0.5,333.3333333333333,833.3333333333333,2020-02-22
54,1,15,26,0.06666666666666667,166.66666666666666,999.9999999999999,2020-02-23
55,0,13,39,0.0,0.0,999.9999999999999,2020-02-24
56,0,19,58,0.0,0.0,999.9999999999999,2020-02-25
57,3,16,74,0.1875,500.0,1500.0,2020-02-26
58,1,12,86,0.08333333333333333,166.66666666666666,1666.6666666666667,2020-02-27
59,1,17,103,0.058823529411764705,166.66666666666666,1833.3333333333335,2020-02-28
60,0,5,108,0.0,0.0,1833.3333333333335,2020-02-29
61,7,44,152,0.1590909090909091,1166.6666666666667,3000.0,2020-03-01
62,3,18,170,0.16666666666666666,500.0,3500.0,2020-03-02
63,5,12,182,0.4166666666666667,833.3333333333334,4333.333333333333,2020-03-03
64,1,14,196,0.07142857142857142,166.66666666666666,4500.0,2020-03-04
65,3,42,238,0.07142857142857142,500.0,5000.0,2020-03-05
66,1,14,252,0.07142857142857142,166.66666666666666,5166.666666666667,2020-03-06
67,0,15,267,0.0,0.0,5166.666666666667,2020-03-07
68,2,22,289,0.09090909090909091,333.3333333333333,5500.0,2020-03-08
69,2,17,306,0.11764705882352941,333.3333333333333,5833.333333333333,2020-03-09
70,3,45,351,0.06666666666666667,500.0,6333.333333333333,2020-03-10
71,1,18,369,0.05555555555555555,166.66666666666666,6500.0,2020-03-11
72,3,18,387,0.16666666666666666,500.0,7000.0,2020-03-12
73,4,27,414,0.14814814814814814,666.6666666666666,7666.666666666667,2020-03-13
74,1,18,432,0.05555555555555555,166.66666666666666,7833.333333333334,2020-03-14
75,4,44,476,0.09090909090909091,666.6666666666666,8500.0,2020-03-15
76,12,36,512,0.3333333333333333,2000.0,10500.0,2020-03-16
77,3,26,538,0.11538461538461539,500.0,11000.0,2020-03-17
78,7,31,569,0.22580645161290322,1166.6666666666667,12166.666666666666,2020-03-18
79,10,33,602,0.30303030303030304,1666.6666666666667,13833.333333333332,2020-03-19
80,23,91,693,0.25274725274725274,3833.333333333333,17666.666666666664,2020-03-20
81,11,37,730,0.2972972972972973,1833.3333333333333,19499.999999999996,2020-03-21
82,13,39,769,0.3333333333333333,2166.6666666666665,21666.666666666664,2020-03-22
83,12,58,827,0.20689655172413793,2000.0,23666.666666666664,2020-03-23
84,11,35,862,0.3142857142857143,1833.3333333333333,25499.999999999996,2020-03-24
85,21,59,921,0.3559322033898305,3500.0,28999.999999999996,2020-03-25
86,23,64,985,0.359375,3833.333333333333,32833.33333333333,2020-03-26
87,16,48,1033,0.3333333333333333,2666.6666666666665,35499.99999999999,2020-03-27
88,17,58,1091,0.29310344827586204,2833.3333333333335,38333.33333333333,2020-03-28
89,19,63,1154,0.30158730158730157,3166.6666666666665,41499.99999999999,2020-03-29
90,31,94,1248,0.32978723404255317,5166.666666666667,46666.66666666666,2020-03-30
91,32,65,1313,0.49230769230769234,5333.333333333333,51999.99999999999,2020-03-31
92,64,157,1470,0.40764331210191085,10666.666666666666,62666.66666666666,2020-04-01
93,49,110,1580,0.44545454545454544,8166.666666666666,70833.33333333333,2020-04-02
94,39,126,1706,0.30952380952380953,6500.0,77333.33333333333,2020-04-03
95,48,122,1828,0.39344262295081966,8000.0,85333.33333333333,2020-04-04
96,49,139,1967,0.35251798561151076,8166.666666666666,93500.0,2020-04-05
97,67,148,2115,0.4527027027027027,11166.666666666666,104666.66666666667,2020-04-06
98,60,144,2259,0.4166666666666667,10000.0,114666.66666666667,2020-04-07
99,58,157,2416,0.36942675159235666,9666.666666666666,124333.33333333334,2020-04-08
100,70,169,2585,0.41420118343195267,11666.666666666666,136000.0,2020-04-09
101,111,307,2892,0.36156351791530944,18500.0,154500.0,2020-04-10
102,77,208,3100,0.3701923076923077,12833.333333333334,167333.33333333334,2020-04-11
103,79,240,3340,0.32916666666666666,13166.666666666666,180500.0,2020-04-12
104,111,290,3630,0.38275862068965516,18500.0,199000.0,2020-04-13
105,108,264,3894,0.4090909090909091,18000.0,217000.0,2020-04-14
106,127,355,4249,0.35774647887323946,21166.666666666668,238166.66666666666,2020-04-15
107,121,306,4555,0.3954248366013072,20166.666666666668,258333.3333333333,2020-04-16
108,137,333,4888,0.4114114114114114,22833.333333333332,281166.6666666666,2020-04-17
109,161,388,5276,0.41494845360824745,26833.333333333332,307999.99999999994,2020-04-18
110,140,355,5631,0.39436619718309857,23333.333333333332,331333.33333333326,2020-04-19
111,292,695,6326,0.4201438848920863,48666.666666666664,379999.99999999994,2020-04-20
112,159,332,6658,0.4789156626506024,26500.0,406499.99999999994,2020-04-21
113,175,403,7061,0.43424317617866004,29166.666666666664,435666.6666666666,2020-04-22
114,195,459,7520,0.42483660130718953,32500.0,468166.6666666666,2020-04-23
115,273,568,8088,0.48063380281690143,45500.0,513666.6666666666,2020-04-24
116,270,597,8685,0.45226130653266333,45000.0,558666.6666666666,2020-04-25
117,243,532,9217,0.4567669172932331,40500.0,599166.6666666666,2020-04-26
118,260,592,9809,0.4391891891891892,43333.333333333336,642500.0,2020-04-27
119,309,616,10425,0.5016233766233766,51500.0,694000.0,2020-04-28
120,243,508,10933,0.47834645669291337,40500.0,734500.0,2020-04-29
121,324,718,11651,0.45125348189415043,54000.0,788500.0,2020-04-30
122,567,1199,12850,0.47289407839866554,94500.0,883000.0,2020-05-01
123,385,759,13609,0.5072463768115942,64166.666666666664,947166.6666666666,2020-05-02
124,326,701,14310,0.46504992867332384,54333.333333333336,1001500.0,2020-05-03
125,409,809,15119,0.5055624227441285,68166.66666666667,1069666.6666666667,2020-05-04
126,427,950,16069,0.4494736842105263,71166.66666666667,1140833.3333333335,2020-05-05
127,344,719,16788,0.47844228094575797,57333.333333333336,1198166.6666666667,2020-05-06
128,327,700,17488,0.46714285714285714,54500.0,1252666.6666666667,2020-05-07
129,382,853,18341,0.447831184056272,63666.666666666664,1316333.3333333335,2020-05-08
130,358,802,19143,0.4463840399002494,59666.666666666664,1376000.0000000002,2020-05-09
131,613,1366,20509,0.44875549048316254,102166.66666666667,1478166.666666667,2020-05-10
132,409,856,21365,0.477803738317757,68166.66666666667,1546333.3333333337,2020-05-11
133,363,813,22178,0.44649446494464945,60500.0,1606833.3333333337,2020-05-12
134,326,763,22941,0.4272608125819135,54333.333333333336,1661166.666666667,2020-05-13
135,363,836,23777,0.4342105263157895,60500.0,1721666.666666667,2020-05-14
136,470,1096,24873,0.42883211678832117,78333.33333333333,1800000.0000000002,2020-05-15
137,357,814,25687,0.43857493857493857,59500.0,1859500.0000000002,2020-05-16
138,303,732,26419,0.4139344262295082,50500.0,1910000.0000000002,2020-05-17
139,374,887,27306,0.42164599774520856,62333.33333333333,1972333.3333333335,2020-05-18
140,323,752,28058,0.4295212765957447,53833.333333333336,2026166.6666666667,2020-05-19
141,490,1176,29234,0.4166666666666667,81666.66666666667,2107833.3333333335,2020-05-20
142,343,779,30013,0.44030808729139925,57166.666666666664,2165000.0,2020-05-21
143,305,765,30778,0.39869281045751637,50833.333333333336,2215833.3333333335,2020-05-22
144,295,690,31468,0.427536231884058,49166.666666666664,2265000.0,2020-05-23
145,291,681,32149,0.42731277533039647,48500.0,2313500.0,2020-05-24
146,427,1023,33172,0.4173998044965787,71166.66666666667,2384666.6666666665,2020-05-25
147,268,719,33891,0.37273991655076494,44666.666666666664,2429333.333333333,2020-05-26
148,285,685,34576,0.41605839416058393,47500.0,2476833.333333333,2020-05-27
149,312,826,35402,0.37772397094430993,52000.0,2528833.333333333,2020-05-28
150,306,768,36170,0.3984375,51000.0,2579833.333333333,2020-05-29
151,253,742,36912,0.34097035040431267,42166.666666666664,2621999.9999999995,2020-05-30
152,242,651,37563,0.3717357910906298,40333.333333333336,2662333.333333333,2020-05-31
153,523,1326,38889,0.39441930618401205,87166.66666666667,2749499.9999999995,2020-06-01
154,331,809,39698,0.40914709517923364,55166.666666666664,2804666.666666666,2020-06-02
155,312,745,40443,0.41879194630872485,52000.0,2856666.666666666,2020-06-03
156,298,740,41183,0.4027027027027027,49666.666666666664,2906333.3333333326,2020-06-04
157,323,875,42058,0.36914285714285716,53833.333333333336,2960166.666666666,2020-06-05
158,275,761,42819,0.36136662286465177,45833.333333333336,3005999.9999999995,2020-06-06
159,244,677,43496,0.3604135893648449,40666.666666666664,3046666.666666666,2020-06-07
160,274,790,44286,0.3468354430379747,45666.666666666664,3092333.3333333326,2020-06-08
161,250,704,44990,0.35511363636363635,41666.666666666664,3133999.999999999,2020-06-09
162,418,1120,46110,0.3732142857142857,69666.66666666667,3203666.6666666656,2020-06-10
163,236,660,46770,0.3575757575757576,39333.333333333336,3242999.999999999,2020-06-11
164,259,823,47593,0.31470230862697446,43166.666666666664,3286166.6666666656,2020-06-12
165,292,768,48361,0.3802083333333333,48666.666666666664,3334833.333333332,2020-06-13
166,265,726,49087,0.3650137741046832,44166.666666666664,3378999.9999999986,2020-06-14
167,338,967,50054,0.34953464322647365,56333.333333333336,3435333.333333332,2020-06-15
168,275,718,50772,0.383008356545961,45833.333333333336,3481166.6666666656,2020-06-16
169,262,732,51504,0.35792349726775957,43666.666666666664,3524833.333333332,2020-06-17
170,280,759,52263,0.3689064558629776,46666.666666666664,3571499.9999999986,2020-06-18
171,273,760,53023,0.3592105263157895,45500.0,3616999.9999999986,2020-06-19
172,351,1067,54090,0.3289597000937207,58500.0,3675499.9999999986,2020-06-20
173,206,581,54671,0.35456110154905335,34333.333333333336,3709833.333333332,2020-06-21
174,263,743,55414,0.35397039030955585,43833.333333333336,3753666.6666666656,2020-06-22
175,236,611,56025,0.3862520458265139,39333.333333333336,3792999.999999999,2020-06-23
176,230,655,56680,0.3511450381679389,38333.333333333336,3831333.3333333326,2020-06-24
177,291,824,57504,0.35315533980582525,48500.0,3879833.3333333326,2020-06-25
178,279,747,58251,0.37349397590361444,46500.0,3926333.3333333326,2020-06-26
179,201,547,58798,0.36745886654478976,33500.0,3959833.3333333326,2020-06-27
180,258,720,59518,0.35833333333333334,43000.0,4002833.3333333326,2020-06-28
181,223,669,60187,0.3333333333333333,37166.666666666664,4039999.999999999,2020-06-29
182,308,815,61002,0.37791411042944784,51333.333333333336,4091333.3333333326,2020-06-30
183,439,1303,62305,0.33691481197237144,73166.66666666667,4164499.999999999,2020-07-01
184,264,737,63042,0.3582089552238806,44000.0,4208499.999999999,2020-07-02
185,270,748,63790,0.3609625668449198,45000.0,4253499.999999999,2020-07-03
186,262,692,64482,0.3786127167630058,43666.666666666664,4297166.666666666,2020-07-04
187,269,742,65224,0.36253369272237196,44833.333333333336,4341999.999999999,2020-07-05
188,280,769,65993,0.3641092327698309,46666.666666666664,4388666.666666666,2020-07-06
189,281,769,66762,0.36540962288686607,46833.333333333336,4435499.999999999,2020-07-07
190,278,759,67521,0.3662714097496706,46333.333333333336,4481833.333333332,2020-07-08
191,233,697,68218,0.33428981348637016,38833.333333333336,4520666.666666665,2020-07-09
192,389,1100,69318,0.35363636363636364,64833.33333333333,4585499.999999998,2020-07-10
193,233,630,69948,0.36984126984126986,38833.333333333336,4624333.333333331,2020-07-11
194,264,693,70641,0.38095238095238093,44000.0,4668333.333333331,2020-07-12
195,223,707,71348,0.31541725601131543,37166.666666666664,4705499.999999998,2020-07-13
196,231,700,72048,0.33,38500.0,4743999.999999998,2020-07-14
197,279,872,72920,0.31995412844036697,46500.0,4790499.999999998,2020-07-15
198,248,668,73588,0.3712574850299401,41333.333333333336,4831833.333333331,2020-07-16
199,222,687,74275,0.3231441048034934,37000.0,4868833.333333331,2020-07-17
200,247,718,74993,0.34401114206128136,41166.666666666664,4909999.999999998,2020-07-18
201,226,626,75619,0.3610223642172524,37666.666666666664,4947666.666666665,2020-07-19
202,337,1063,76682,0.31702728127939794,56166.666666666664,5003833.333333332,2020-07-20
203,189,577,77259,0.3275563258232236,31500.0,5035333.333333332,2020-07-21
204,196,619,77878,0.3166397415185784,32666.666666666664,5067999.999999999,2020-07-22
205,193,592,78470,0.3260135135135135,32166.666666666664,5100166.666666666,2020-07-23
206,200,590,79060,0.3389830508474576,33333.333333333336,5133499.999999999,2020-07-24
207,223,661,79721,0.3373676248108926,37166.666666666664,5170666.666666666,2020-07-25
208,197,565,80286,0.3486725663716814,32833.333333333336,5203499.999999999,2020-07-26
209,204,638,80924,0.31974921630094044,34000.0,5237499.999999999,2020-07-27
210,194,568,81492,0.3415492957746479,32333.333333333332,5269833.333333332,2020-07-28
211,166,463,81955,0.35853131749460043,27666.666666666668,5297499.999999999,2020-07-29
212,180,543,82498,0.3314917127071823,30000.0,5327499.999999999,2020-07-30
213,178,502,83000,0.3545816733067729,29666.666666666664,5357166.666666666,2020-07-31
214,277,920,83920,0.3010869565217391,46166.666666666664,5403333.333333333,2020-08-01
215,181,538,84458,0.33643122676579923,30166.666666666664,5433500.0,2020-08-02
216,183,600,85058,0.305,30500.0,5464000.0,2020-08-03
217,187,557,85615,0.3357271095152603,31166.666666666664,5495166.666666667,2020-08-04
218,168,564,86179,0.2978723404255319,28000.0,5523166.666666667,2020-08-05
219,173,521,86700,0.33205374280230326,28833.333333333332,5552000.0,2020-08-06
220,171,541,87241,0.31608133086876156,28500.0,5580500.0,2020-08-07
221,201,552,87793,0.3641304347826087,33500.0,5614000.0,2020-08-08
222,135,459,88252,0.29411764705882354,22500.0,5636500.0,2020-08-09
223,300,959,89211,0.31282586027111575,50000.0,5686500.0,2020-08-10
224,149,503,89714,0.2962226640159046,24833.333333333332,5711333.333333333,2020-08-11
225,179,523,90237,0.3422562141491396,29833.333333333332,5741166.666666666,2020-08-12
226,159,484,90721,0.3285123966942149,26500.0,5767666.666666666,2020-08-13
227,144,549,91270,0.26229508196721313,24000.0,5791666.666666666,2020-08-14
228,203,657,91927,0.3089802130898021,33833.333333333336,5825499.999999999,2020-08-15
229,146,448,92375,0.32589285714285715,24333.333333333332,5849833.333333332,2020-08-16
230,154,530,92905,0.29056603773584905,25666.666666666668,5875499.999999999,2020-08-17
231,155,507,93412,0.3057199211045365,25833.333333333332,5901333.333333332,2020-08-18
232,153,472,93884,0.3241525423728814,25500.0,5926833.333333332,2020-08-19
233,232,798,94682,0.2907268170426065,38666.666666666664,5965499.999999999,2020-08-20
234,137,467,95149,0.29336188436830835,22833.333333333332,5988333.333333332,2020-08-21
235,112,453,95602,0.24724061810154527,18666.666666666668,6006999.999999999,2020-08-22
236,125,417,96019,0.2997601918465228,20833.333333333332,6027833.333333332,2020-08-23
237,142,449,96468,0.31625835189309576,23666.666666666668,6051499.999999999,2020-08-24
238,152,540,97008,0.2814814814814815,25333.333333333332,6076833.333333332,2020-08-25
239,133,392,97400,0.3392857142857143,22166.666666666668,6098999.999999999,2020-08-26
240,115,417,97817,0.27577937649880097,19166.666666666668,6118166.666666666,2020-08-27
241,145,565,98382,0.25663716814159293,24166.666666666668,6142333.333333333,2020-08-28
242,107,318,98700,0.33647798742138363,17833.333333333332,6160166.666666666,2020-08-29
243,122,432,99132,0.2824074074074074,20333.333333333332,6180499.999999999,2020-08-30
244,130,397,99529,0.327455919395466,21666.666666666668,6202166.666666666,2020-08-31
245,212,740,100269,0.2864864864864865,35333.333333333336,6237499.999999999,2020-09-01
246,131,402,100671,0.32587064676616917,21833.333333333332,6259333.333333332,2020-09-02
247,105,362,101033,0.2900552486187845,17500.0,6276833.333333332,2020-09-03
248,105,339,101372,0.30973451327433627,17500.0,6294333.333333332,2020-09-04
249,124,484,101856,0.256198347107438,20666.666666666668,6314999.999999999,2020-09-05
250,107,337,102193,0.31750741839762614,17833.333333333332,6332833.333333332,2020-09-06
251,127,399,102592,0.3182957393483709,21166.666666666668,6353999.999999999,2020-09-07
252,120,467,103059,0.2569593147751606,20000.0,6373999.999999999,2020-09-08
253,120,405,103464,0.2962962962962963,20000.0,6393999.999999999,2020-09-09
254,165,579,104043,0.2849740932642487,27500.0,6421499.999999999,2020-09-10
255,109,360,104403,0.30277777777777776,18166.666666666668,6439666.666666666,2020-09-11
256,114,355,104758,0.3211267605633803,19000.0,6458666.666666666,2020-09-12
257,100,331,105089,0.3021148036253776,16666.666666666668,6475333.333333333,2020-09-13
258,96,405,105494,0.23703703703703705,16000.0,6491333.333333333,2020-09-14
259,118,458,105952,0.2576419213973799,19666.666666666668,6511000.0,2020-09-15
260,79,330,106282,0.23939393939393938,13166.666666666666,6524166.666666667,2020-09-16
261,121,374,106656,0.3235294117647059,20166.666666666668,6544333.333333334,2020-09-17
262,131,416,107072,0.31490384615384615,21833.333333333332,6566166.666666667,2020-09-18
263,99,329,107401,0.3009118541033435,16500.0,6582666.666666667,2020-09-19
264,148,554,107955,0.26714801444043323,24666.666666666668,6607333.333333334,2020-09-20
265,90,342,108297,0.2631578947368421,15000.0,6622333.333333334,2020-09-21
266,94,332,108629,0.28313253012048195,15666.666666666666,6638000.000000001,2020-09-22
267,78,318,108947,0.24528301886792453,13000.0,6651000.000000001,2020-09-23
268,70,291,109238,0.24054982817869416,11666.666666666666,6662666.666666668,2020-09-24
269,132,463,109701,0.28509719222462204,22000.0,6684666.666666668,2020-09-25
270,70,285,109986,0.24561403508771928,11666.666666666666,6696333.333333335,2020-09-26
271,68,281,110267,0.24199288256227758,11333.333333333334,6707666.666666668,2020-09-27
272,99,363,110630,0.2727272727272727,16500.0,6724166.666666668,2020-09-28
273,96,304,110934,0.3157894736842105,16000.0,6740166.666666668,2020-09-29
274,90,362,111296,0.24861878453038674,15000.0,6755166.666666668,2020-09-30
275,149,605,111901,0.2462809917355372,24833.333333333332,6780000.000000001,2020-10-01
276,82,345,112246,0.23768115942028986,13666.666666666666,6793666.666666668,2020-10-02
277,74,277,112523,0.26714801444043323,12333.333333333334,6806000.000000001,2020-10-03
278,72,288,112811,0.25,12000.0,6818000.000000001,2020-10-04
279,89,374,113185,0.23796791443850268,14833.333333333332,6832833.333333334,2020-10-05
280,86,314,113499,0.27388535031847133,14333.333333333334,6847166.666666667,2020-10-06
281,78,302,113801,0.2582781456953642,13000.0,6860166.666666667,2020-10-07
282,87,312,114113,0.27884615384615385,14500.0,6874666.666666667,2020-10-08
283,93,357,114470,0.2605042016806723,15500.0,6890166.666666667,2020-10-09
284,126,481,114951,0.26195426195426197,21000.0,6911166.666666667,2020-10-10
285,62,252,115203,0.24603174603174602,10333.333333333334,6921500.0,2020-10-11
286,70,326,115529,0.2147239263803681,11666.666666666666,6933166.666666667,2020-10-12
287,83,386,115915,0.21502590673575128,13833.333333333334,6947000.0,2020-10-13
288,75,353,116268,0.21246458923512748,12500.0,6959500.0,2020-10-14
289,95,439,116707,0.2164009111617312,15833.333333333332,6975333.333333333,2020-10-15
290,81,285,116992,0.28421052631578947,13500.0,6988833.333333333,2020-10-16
291,75,312,117304,0.2403846153846154,12500.0,7001333.333333333,2020-10-17
292,89,346,117650,0.25722543352601157,14833.333333333332,7016166.666666666,2020-10-18
293,95,384,118034,0.24739583333333334,15833.333333333332,7031999.999999999,2020-10-19
294,114,524,118558,0.21755725190839695,19000.0,7050999.999999999,2020-10-20
295,83,312,118870,0.266025641025641,13833.333333333334,7064833.333333332,2020-10-21
296,78,325,119195,0.24,13000.0,7077833.333333332,2020-10-22
297,74,330,119525,0.22424242424242424,12333.333333333334,7090166.666666665,2020-10-23
298,62,268,119793,0.23134328358208955,10333.333333333334,7100499.999999998,2020-10-24
299,96,399,120192,0.24060150375939848,16000.0,7116499.999999998,2020-10-25
300,73,353,120545,0.20679886685552407,12166.666666666666,7128666.666666665,2020-10-26
301,78,298,120843,0.26174496644295303,13000.0,7141666.666666665,2020-10-27
302,85,341,121184,0.24926686217008798,14166.666666666666,7155833.333333332,2020-10-28
303,73,335,121519,0.21791044776119403,12166.666666666666,7167999.999999999,2020-10-29
304,77,370,121889,0.20810810810810812,12833.333333333334,7180833.333333332,2020-10-30
305,57,248,122137,0.22983870967741934,9500.0,7190333.333333332,2020-10-31
306,143,665,122802,0.21503759398496242,23833.333333333332,7214166.666666665,2020-11-01
307,96,414,123216,0.2318840579710145,16000.0,7230166.666666665,2020-11-02
308,78,420,123636,0.18571428571428572,13000.0,7243166.666666665,2020-11-03
309,73,412,124048,0.17718446601941748,12166.666666666666,7255333.333333332,2020-11-04
310,105,470,124518,0.22340425531914893,17500.0,7272833.333333332,2020-11-05
311,78,416,124934,0.1875,13000.0,7285833.333333332,2020-11-06
312,78,347,125281,0.22478386167146974,13000.0,7298833.333333332,2020-11-07
313,102,380,125661,0.26842105263157895,17000.0,7315833.333333332,2020-11-08
314,92,467,126128,0.19700214132762311,15333.333333333332,7331166.666666665,2020-11-09
315,139,669,126797,0.2077727952167414,23166.666666666668,7354333.333333332,2020-11-10
316,98,429,127226,0.22843822843822845,16333.333333333332,7370666.666666665,2020-11-11
317,92,455,127681,0.2021978021978022,15333.333333333332,7385999.999999998,2020-11-12
318,108,464,128145,0.23275862068965517,18000.0,7403999.999999998,2020-11-13
319,105,454,128599,0.23127753303964757,17500.0,7421499.999999998,2020-11-14
320,152,659,129258,0.2306525037936267,25333.333333333332,7446833.333333331,2020-11-15
321,131,648,129906,0.2021604938271605,21833.333333333332,7468666.666666664,2020-11-16
322,130,670,130576,0.19402985074626866,21666.666666666668,7490333.333333331,2020-11-17
323,128,639,131215,0.20031298904538342,21333.333333333332,7511666.666666664,2020-11-18
324,135,687,131902,0.1965065502183406,22500.0,7534166.666666664,2020-11-19
325,206,1147,133049,0.17959895379250218,34333.333333333336,7568499.999999997,2020-11-20
326,110,589,133638,0.1867572156196944,18333.333333333332,7586833.33333333,2020-11-21
327,138,669,134307,0.2062780269058296,23000.0,7609833.33333333,2020-11-22
328,148,886,135193,0.1670428893905192,24666.666666666668,7634499.999999997,2020-11-23
329,136,742,135935,0.18328840970350405,22666.666666666668,7657166.666666664,2020-11-24
330,168,915,136850,0.18360655737704917,28000.0,7685166.666666664,2020-11-25
331,131,760,137610,0.1723684210526316,21833.333333333332,7706999.999999997,2020-11-26
332,148,824,138434,0.1796116504854369,24666.666666666668,7731666.666666664,2020-11-27
333,136,813,139247,0.16728167281672818,22666.666666666668,7754333.333333331,2020-11-28
334,121,681,139928,0.1776798825256975,20166.666666666668,7774499.999999998,2020-11-29
335,221,1188,141116,0.18602693602693604,36833.333333333336,7811333.333333331,2020-11-30
336,276,1613,142729,0.17110973341599503,46000.0,7857333.333333331,2020-12-01
337,190,957,143686,0.19853709508881923,31666.666666666664,7888999.999999998,2020-12-02
338,153,957,144643,0.15987460815047022,25500.0,7914499.999999998,2020-12-03
339,159,964,145607,0.16493775933609958,26500.0,7940999.999999998,2020-12-04
340,157,980,146587,0.16020408163265307,26166.666666666668,7967166.666666665,2020-12-05
341,144,803,147390,0.1793275217932752,24000.0,7991166.666666665,2020-12-06
342,191,1036,148426,0.18436293436293436,31833.333333333332,8022999.999999998,2020-12-07
343,185,1038,149464,0.17822736030828518,30833.333333333332,8053833.333333331,2020-12-08
344,172,927,150391,0.1855447680690399,28666.666666666668,8082499.999999998,2020-12-09
345,241,1390,151781,0.17338129496402876,40166.666666666664,8122666.666666665,2020-12-10
346,148,937,152718,0.15795090715048027,24666.666666666668,8147333.333333332,2020-12-11
347,127,867,153585,0.14648212226066898,21166.666666666668,8168499.999999999,2020-12-12
348,151,829,154414,0.18214716525934863,25166.666666666668,8193666.666666666,2020-12-13
349,188,1060,155474,0.17735849056603772,31333.333333333332,8224999.999999999,2020-12-14
350,192,1115,156589,0.17219730941704037,32000.0,8256999.999999999,2020-12-15
351,139,857,157446,0.16219369894982497,23166.666666666668,8280166.666666666,2020-12-16
352,146,1205,158651,0.12116182572614108,24333.333333333332,8304499.999999999,2020-12-17
353,168,1095,159746,0.15342465753424658,28000.0,8332499.999999999,2020-12-18
354,139,824,160570,0.16868932038834952,23166.666666666668,8355666.666666666,2020-12-19
355,221,1267,161837,0.17442778216258878,36833.333333333336,8392500.0,2020-12-20
356,133,989,162826,0.134479271991911,22166.666666666668,8414666.666666666,2020-12-21
357,156,945,163771,0.16507936507936508,26000.0,8440666.666666666,2020-12-22
358,159,1015,164786,0.1566502463054187,26500.0,8467166.666666666,2020-12-23
359,171,955,165741,0.17905759162303664,28500.0,8495666.666666666,2020-12-24
360,177,1150,166891,0.15391304347826087,29500.0,8525166.666666666,2020-12-25
361,158,1118,168009,0.1413237924865832,26333.333333333332,8551500.0,2020-12-26
362,167,1029,169038,0.16229348882410108,27833.333333333332,8579333.333333334,2020-12-27
363,193,1377,170415,0.140159767610748,32166.666666666664,8611500.0,2020-12-28
364,152,971,171386,0.15653964984552007,25333.333333333332,8636833.333333334,2020-12-29
365,172,1179,172565,0.1458863443596268,28666.666666666668,8665500.0,2020-12-30
366,172,1224,173789,0.14052287581699346,28666.666666666668,8694166.666666666,2020-12-31
367,392,2974,176763,0.13180901143241425,65333.33333333333,8759500.0,2021-01-01
368,226,1860,178623,0.12150537634408602,37666.666666666664,8797166.666666666,2021-01-02
369,215,1757,180380,0.12236767216846899,35833.333333333336,8833000.0,2021-01-03
370,241,2105,182485,0.11448931116389549,40166.666666666664,8873166.666666666,2021-01-04
371,264,2311,184796,0.11423626135871917,44000.0,8917166.666666666,2021-01-05
372,193,1667,186463,0.11577684463107378,32166.666666666664,8949333.333333332,2021-01-06
373,238,1745,188208,0.13638968481375358,39666.666666666664,8988999.999999998,2021-01-07
374,254,2139,190347,0.1187470780738663,42333.333333333336,9031333.333333332,2021-01-08
375,213,1682,192029,0.12663495838287753,35500.0,9066833.333333332,2021-01-09
376,377,2907,194936,0.12968696250429995,62833.33333333333,9129666.666666666,2021-01-10
377,219,2002,196938,0.10939060939060939,36500.0,9166166.666666666,2021-01-11
378,192,1949,198887,0.09851205746536686,32000.0,9198166.666666666,2021-01-12
379,200,1754,200641,0.11402508551881414,33333.333333333336,9231500.0,2021-01-13
380,234,1852,202493,0.1263498920086393,39000.0,9270500.0,2021-01-14
381,298,2858,205351,0.10426871938418475,49666.666666666664,9320166.666666666,2021-01-15
382,215,1761,207112,0.12208972174900624,35833.333333333336,9356000.0,2021-01-16
383,177,1714,208826,0.10326721120186698,29500.0,9385500.0,2021-01-17
384,260,2625,211451,0.09904761904761905,43333.333333333336,9428833.333333334,2021-01-18
385,185,2039,213490,0.09073075036782736,30833.333333333332,9459666.666666668,2021-01-19
386,319,3598,217088,0.0886603668704836,53166.666666666664,9512833.333333334,2021-01-20
387,188,2269,219357,0.08285588364918467,31333.333333333332,9544166.666666668,2021-01-21
388,206,2534,221891,0.08129439621152329,34333.333333333336,9578500.000000002,2021-01-22
389,196,2115,224006,0.09267139479905437,32666.666666666664,9611166.666666668,2021-01-23
390,234,2089,226095,0.11201531833413117,39000.0,9650166.666666668,2021-01-24
391,288,4019,230114,0.07165961682010451,48000.0,9698166.666666668,2021-01-25
392,190,2735,232849,0.06946983546617916,31666.666666666664,9729833.333333334,2021-01-26
393,212,2791,235640,0.07595843783590112,35333.333333333336,9765166.666666668,2021-01-27
394,229,3666,239306,0.062465902891434805,38166.666666666664,9803333.333333334,2021-01-28
395,178,3210,242516,0.05545171339563863,29666.666666666664,9833000.0,2021-01-29
396,178,3295,245811,0.054021244309559936,29666.666666666664,9862666.666666666,2021-01-30
397,197,2971,248782,0.06630764052507573,32833.333333333336,9895500.0,2021-01-31
398,491,8789,257571,0.055865286153145975,81833.33333333333,9977333.333333334,2021-02-01
399,323,5624,263195,0.057432432432432436,53833.333333333336,10031166.666666668,2021-02-02
400,235,5190,268385,0.04527938342967245,39166.666666666664,10070333.333333334,2021-02-03
401,266,5472,273857,0.04861111111111111,44333.333333333336,10114666.666666668,2021-02-04
402,283,7387,281244,0.03831054555299851,47166.666666666664,10161833.333333334,2021-02-05
403,216,6134,287378,0.035213563743071406,36000.0,10197833.333333334,2021-02-06
404,239,6418,293796,0.03723901526955438,39833.333333333336,10237666.666666668,2021-02-07
405,285,9306,303102,0.030625402965828497,47500.0,10285166.666666668,2021-02-08
406,264,7921,311023,0.03332912511046585,44000.0,10329166.666666668,2021-02-09
407,415,11109,322132,0.03735709784859123,69166.66666666667,10398333.333333334,2021-02-10
408,240,7746,329878,0.030983733539891558,40000.0,10438333.333333334,2021-02-11
409,287,9626,339504,0.0298150841471016,47833.333333333336,10486166.666666668,2021-02-12
410,252,7923,347427,0.03180613404013631,42000.0,10528166.666666668,2021-02-13
411,310,8201,355628,0.037800268259968295,51666.666666666664,10579833.333333334,2021-02-14
412,402,12531,368159,0.032080440507541295,67000.0,10646833.333333334,2021-02-15
413,293,9072,377231,0.032297178130511466,48833.333333333336,10695666.666666668,2021-02-16
414,322,9819,387050,0.03279356349933802,53666.666666666664,10749333.333333334,2021-02-17
415,406,11463,398513,0.03541830236412807,67666.66666666667,10817000.0,2021-02-18
416,355,11516,410029,0.030826675929142063,59166.666666666664,10876166.666666666,2021-02-19
417,552,13811,423840,0.03996814133661574,92000.0,10968166.666666666,2021-02-20
418,338,9425,433265,0.03586206896551724,56333.333333333336,11024500.0,2021-02-21
419,444,13414,446679,0.033099746533472495,74000.0,11098500.0,2021-02-22
420,353,10535,457214,0.03350735643094447,58833.33333333333,11157333.333333334,2021-02-23
421,383,10702,467916,0.035787703233040556,63833.33333333333,11221166.666666668,2021-02-24
422,468,12911,480827,0.036248160483308804,78000.0,11299166.666666668,2021-02-25
423,497,13343,494170,0.03724799520347748,82833.33333333333,11382000.000000002,2021-02-26
424,448,11556,505726,0.03876773970231914,74666.66666666667,11456666.666666668,2021-02-27
425,580,14303,520029,0.040550933370621545,96666.66666666667,11553333.333333334,2021-02-28
426,931,22662,542691,0.04108198746800812,155166.66666666666,11708500.0,2021-03-01
427,584,14525,557216,0.0402065404475043,97333.33333333333,11805833.333333334,2021-03-02
428,496,14090,571306,0.03520227111426544,82666.66666666667,11888500.0,2021-03-03
429,532,13695,585001,0.038846294267981016,88666.66666666667,11977166.666666666,2021-03-04
430,670,17345,602346,0.038627846641683485,111666.66666666667,12088833.333333332,2021-03-05
431,537,13573,615919,0.039563839976423786,89500.0,12178333.333333332,2021-03-06
432,548,12868,628787,0.042586260491140816,91333.33333333333,12269666.666666666,2021-03-07
433,674,17990,646777,0.03746525847693163,112333.33333333333,12382000.0,2021-03-08
434,587,14929,661706,0.03931944537477393,97833.33333333333,12479833.333333334,2021-03-09
435,932,19420,681126,0.04799176107106076,155333.33333333334,12635166.666666668,2021-03-10
436,560,13589,694715,0.04120980204577231,93333.33333333333,12728500.000000002,2021-03-11
437,604,16873,711588,0.035796835180465836,100666.66666666667,12829166.666666668,2021-03-12
438,572,14007,725595,0.04083672449489541,95333.33333333333,12924500.000000002,2021-03-13
439,553,13445,739040,0.041130531796206765,92166.66666666667,13016666.666666668,2021-03-14
440,755,20039,759079,0.03767653076500824,125833.33333333333,13142500.000000002,2021-03-15
441,546,14016,773095,0.0389554794520548,91000.0,13233500.000000002,2021-03-16
442,574,13910,787005,0.04126527677929547,95666.66666666667,13329166.666666668,2021-03-17
443,583,15024,802029,0.03880457933972311,97166.66666666667,13426333.333333334,2021-03-18
444,633,15745,817774,0.04020323912353128,105500.0,13531833.333333334,2021-03-19
445,831,18433,836207,0.04508218955134813,138500.0,13670333.333333334,2021-03-20
446,506,11550,847757,0.04380952380952381,84333.33333333333,13754666.666666668,2021-03-21
447,586,16090,863847,0.03642013673088875,97666.66666666667,13852333.333333334,2021-03-22
448,513,13028,876875,0.039376727049431993,85500.0,13937833.333333334,2021-03-23
449,536,12419,889294,0.043159674692004185,89333.33333333333,14027166.666666668,2021-03-24
450,665,14438,903732,0.046059010943343956,110833.33333333333,14138000.000000002,2021-03-25
451,524,13854,917586,0.03782301140464848,87333.33333333333,14225333.333333336,2021-03-26
452,456,10846,928432,0.04204314954822054,76000.0,14301333.333333336,2021-03-27
453,513,11148,939580,0.04601722282023681,85500.0,14386833.333333336,2021-03-28
454,516,13067,952647,0.039488788551312465,86000.0,14472833.333333336,2021-03-29
455,479,11617,964264,0.0412326762503228,79833.33333333333,14552666.66666667,2021-03-30
456,412,10836,975100,0.03802141011443337,68666.66666666667,14621333.333333336,2021-03-31
457,792,18095,993195,0.04376899696048632,132000.0,14753333.333333336,2021-04-01
458,513,12831,1006026,0.03998129530044424,85500.0,14838833.333333336,2021-04-02
459,493,12149,1018175,0.04057947156144539,82166.66666666667,14921000.000000002,2021-04-03
460,483,12466,1030641,0.03874538745387454,80500.0,15001500.000000002,2021-04-04
461,538,16308,1046949,0.03298994358597008,89666.66666666667,15091166.666666668,2021-04-05
462,439,12214,1059163,0.03594236122482397,73166.66666666667,15164333.333333334,2021-04-06
463,439,11280,1070443,0.03891843971631206,73166.66666666667,15237500.0,2021-04-07
464,445,12617,1083060,0.0352698739795514,74166.66666666667,15311666.666666666,2021-04-08
465,478,13688,1096748,0.034921098772647576,79666.66666666667,15391333.333333332,2021-04-09
466,658,15410,1112158,0.042699545749513304,109666.66666666667,15500999.999999998,2021-04-10
467,391,10206,1122364,0.03831079757005683,65166.666666666664,15566166.666666664,2021-04-11
468,421,13950,1136314,0.03017921146953405,70166.66666666667,15636333.33333333,2021-04-12
469,360,10864,1147178,0.03313696612665685,60000.0,15696333.33333333,2021-04-13
470,377,11084,1158262,0.034012991699747384,62833.33333333333,15759166.666666664,2021-04-14
471,476,12630,1170892,0.037688044338875695,79333.33333333333,15838499.999999998,2021-04-15
472,392,12343,1183235,0.03175889167949445,65333.33333333333,15903833.333333332,2021-04-16
473,315,10124,1193359,0.03111418411694982,52500.0,15956333.333333332,2021-04-17
474,367,10586,1203945,0.03466843000188929,61166.666666666664,16017499.999999998,2021-04-18
475,372,13547,1217492,0.02745995423340961,62000.0,16079499.999999998,2021-04-19
476,529,14723,1232215,0.03593017727365347,88166.66666666667,16167666.666666664,2021-04-20
477,297,9406,1241621,0.03157559004890496,49500.0,16217166.666666664,2021-04-21
478,370,11745,1253366,0.031502767134951044,61666.666666666664,16278833.33333333,2021-04-22
479,340,12922,1266288,0.026311716452561522,56666.666666666664,16335499.999999996,2021-04-23
480,339,11734,1278022,0.028890403954320777,56500.0,16391999.999999996,2021-04-24
481,406,12366,1290388,0.032831958596150734,67666.66666666667,16459666.666666662,2021-04-25
482,325,13971,1304359,0.02326247226397538,54166.666666666664,16513833.333333328,2021-04-26
483,351,11283,1315642,0.031108747673491092,58500.0,16572333.333333328,2021-04-27
484,350,11444,1327086,0.0305837119888151,58333.33333333333,16630666.666666662,2021-04-28
485,303,10451,1337537,0.028992440914745,50500.0,16681166.666666662,2021-04-29
486,395,14194,1351731,0.02782865999718191,65833.33333333333,16746999.999999996,2021-04-30
487,574,16724,1368455,0.034321932552021046,95666.66666666667,16842666.666666664,2021-05-01
488,347,12061,1380516,0.02877041704667938,57833.333333333336,16900499.999999996,2021-05-02
489,350,14885,1395401,0.0235136042996305,58333.33333333333,16958833.33333333,2021-05-03
490,319,12482,1407883,0.0255568017945842,53166.666666666664,17011999.999999996,2021-05-04
491,410,13715,1421598,0.02989427633977397,68333.33333333333,17080333.33333333,2021-05-05
492,335,12709,1434307,0.02635927295617279,55833.333333333336,17136166.66666666,2021-05-06
493,336,14246,1448553,0.023585567878702793,56000.0,17192166.66666666,2021-05-07
494,357,13825,1462378,0.025822784810126582,59500.0,17251666.66666666,2021-05-08
495,361,13784,1476162,0.026189785258270457,60166.666666666664,17311833.33333333,2021-05-09
496,598,21645,1497807,0.02762762762762763,99666.66666666667,17411499.999999996,2021-05-10
497,371,14063,1511870,0.026381284221005476,61833.33333333333,17473333.33333333,2021-05-11
498,404,14246,1526116,0.028358837568440265,67333.33333333333,17540666.66666666,2021-05-12
499,386,14144,1540260,0.027290723981900453,64333.33333333333,17604999.999999993,2021-05-13
500,358,16884,1557144,0.021203506278133145,59666.666666666664,17664666.66666666,2021-05-14
501,460,17918,1575062,0.02567250809242103,76666.66666666667,17741333.33333333,2021-05-15
502,345,14642,1589704,0.02356235486955334,57500.0,17798833.33333333,2021-05-16
503,429,18793,1608497,0.022827648592561058,71500.0,17870333.33333333,2021-05-17
504,360,16184,1624681,0.022244191794364803,60000.0,17930333.33333333,2021-05-18
505,319,15543,1640224,0.020523708421797595,53166.666666666664,17983499.999999996,2021-05-19
506,536,20174,1660398,0.02656885099633191,89333.33333333333,18072833.33333333,2021-05-20
507,337,16737,1677135,0.020135030172671327,56166.666666666664,18128999.999999996,2021-05-21
508,332,14950,1692085,0.022207357859531773,55333.333333333336,18184333.33333333,2021-05-22
509,307,13712,1705797,0.022389148191365227,51166.666666666664,18235499.999999996,2021-05-23
510,365,18028,1723825,0.020246283558908364,60833.33333333333,18296333.33333333,2021-05-24
511,439,17562,1741387,0.024997152943856054,73166.66666666667,18369499.999999996,2021-05-25
512,328,14009,1755396,0.023413519880077092,54666.666666666664,18424166.666666664,2021-05-26
513,346,13706,1769102,0.025244418502845468,57666.666666666664,18481833.333333332,2021-05-27
514,340,16201,1785303,0.02098635886673662,56666.666666666664,18538500.0,2021-05-28
515,260,12145,1797448,0.02140798682585426,43333.333333333336,18581833.333333332,2021-05-29
516,297,12040,1809488,0.024667774086378737,49500.0,18631333.333333332,2021-05-30
517,336,14605,1824093,0.023005819924683327,56000.0,18687333.333333332,2021-05-31
518,513,18407,1842500,0.027869832129081326,85500.0,18772833.333333332,2021-06-01
519,335,13655,1856155,0.024533138044672283,55833.333333333336,18828666.666666664,2021-06-02
520,285,12553,1868708,0.022703736158687166,47500.0,18876166.666666664,2021-06-03
521,327,14671,1883379,0.02228886919773703,54500.0,18930666.666666664,2021-06-04
522,299,13565,1896944,0.02204201990416513,49833.333333333336,18980499.999999996,2021-06-05
523,282,11894,1908838,0.023709433327728267,47000.0,19027499.999999996,2021-06-06
524,272,14416,1923254,0.018867924528301886,45333.333333333336,19072833.33333333,2021-06-07
525,267,11616,1934870,0.022985537190082644,44500.0,19117333.33333333,2021-06-08
526,256,11080,1945950,0.023104693140794223,42666.666666666664,19159999.999999996,2021-06-09
527,364,14302,1960252,0.025450985876101246,60666.666666666664,19220666.666666664,2021-06-10
528,224,11706,1971958,0.01913548607551683,37333.333333333336,19257999.999999996,2021-06-11
529,222,10683,1982641,0.020780679584386407,37000.0,19294999.999999996,2021-06-12
530,215,9714,1992355,0.02213300391187976,35833.333333333336,19330833.33333333,2021-06-13
531,240,12551,2004906,0.01912198231216636,40000.0,19370833.33333333,2021-06-14
532,252,10520,2015426,0.023954372623574145,42000.0,19412833.33333333,2021-06-15
533,195,9133,2024559,0.02135114420234315,32500.0,19445333.33333333,2021-06-16
534,196,9179,2033738,0.021353088571739842,32666.666666666664,19477999.999999996,2021-06-17
535,224,10654,2044392,0.02102496714848883,37333.333333333336,19515333.33333333,2021-06-18
536,168,8707,2053099,0.019294820259561273,28000.0,19543333.33333333,2021-06-19
537,267,9796,2062895,0.027256022866476114,44500.0,19587833.33333333,2021-06-20
538,195,9044,2071939,0.02156125608137992,32500.0,19620333.33333333,2021-06-21
539,141,7714,2079653,0.018278454757583613,23500.0,19643833.33333333,2021-06-22
540,129,7409,2087062,0.017411256579835336,21500.0,19665333.33333333,2021-06-23
541,147,7067,2094129,0.020800905617659543,24500.0,19689833.33333333,2021-06-24
542,197,8862,2102991,0.022229744978560145,32833.333333333336,19722666.66666666,2021-06-25
543,168,7607,2110598,0.022084921782568687,28000.0,19750666.66666666,2021-06-26
544,130,6243,2116841,0.02082332212077527,21666.666666666668,19772333.33333333,2021-06-27
545,181,8430,2125271,0.021470937129300118,30166.666666666664,19802499.999999996,2021-06-28
546,121,6046,2131317,0.020013231888852134,20166.666666666668,19822666.666666664,2021-06-29
547,150,7032,2138349,0.021331058020477817,25000.0,19847666.666666664,2021-06-30
548,237,8987,2147336,0.026371425392233225,39500.0,19887166.666666664,2021-07-01
549,158,7481,2154817,0.021120171100120304,26333.333333333332,19913499.999999996,2021-07-02
550,143,6552,2161369,0.021825396825396824,23833.333333333332,19937333.33333333,2021-07-03
551,126,6004,2167373,0.020986009327115255,21000.0,19958333.33333333,2021-07-04
552,155,8145,2175518,0.019030079803560467,25833.333333333332,19984166.66666666,2021-07-05
553,106,6192,2181710,0.017118863049095608,17666.666666666668,20001833.33333333,2021-07-06
554,122,5902,2187612,0.020670958996950185,20333.333333333332,20022166.66666666,2021-07-07
555,123,6170,2193782,0.01993517017828201,20500.0,20042666.66666666,2021-07-08
556,118,6705,2200487,0.017598806860551826,19666.666666666668,20062333.33333333,2021-07-09
557,191,7781,2208268,0.024546973396735637,31833.333333333332,20094166.66666666,2021-07-10
558,79,5251,2213519,0.015044753380308513,13166.666666666666,20107333.33333333,2021-07-11
559,112,7184,2220703,0.015590200445434299,18666.666666666668,20125999.999999996,2021-07-12
560,96,5414,2226117,0.01773180642777983,16000.0,20141999.999999996,2021-07-13
561,104,5072,2231189,0.02050473186119874,17333.333333333332,20159333.33333333,2021-07-14
562,125,5888,2237077,0.021229619565217392,20833.333333333332,20180166.66666666,2021-07-15
563,79,5680,2242757,0.013908450704225353,13166.666666666666,20193333.33333333,2021-07-16
564,94,4913,2247670,0.019132912680643193,15666.666666666666,20208999.999999996,2021-07-17
565,100,4666,2252336,0.021431633090441493,16666.666666666668,20225666.666666664,2021-07-18
566,103,6043,2258379,0.01704451431408241,17166.666666666668,20242833.333333332,2021-07-19
567,135,5753,2264132,0.02346601772988006,22500.0,20265333.333333332,2021-07-20
568,84,4087,2268219,0.02055297284071446,14000.0,20279333.333333332,2021-07-21
569,91,4123,2272342,0.022071307300509338,15166.666666666666,20294500.0,2021-07-22
570,76,4465,2276807,0.01702127659574468,12666.666666666666,20307166.666666668,2021-07-23
571,73,3709,2280516,0.019681854947425182,12166.666666666666,20319333.333333336,2021-07-24
572,81,4165,2284681,0.019447779111644657,13500.0,20332833.333333336,2021-07-25
573,73,4311,2288992,0.016933426119229877,12166.666666666666,20345000.000000004,2021-07-26
574,77,3523,2292515,0.021856372409877946,12833.333333333334,20357833.333333336,2021-07-27
575,55,3373,2295888,0.01630595908686629,9166.666666666666,20367000.000000004,2021-07-28
576,70,3214,2299102,0.021779713752333542,11666.666666666666,20378666.66666667,2021-07-29
577,70,3633,2302735,0.019267822736030827,11666.666666666666,20390333.33333334,2021-07-30
578,57,2923,2305658,0.019500513171399246,9500.0,20399833.33333334,2021-07-31
579,100,4290,2309948,0.023310023310023312,16666.666666666668,20416500.000000007,2021-08-01
580,85,3753,2313701,0.022648547828403944,14166.666666666666,20430666.666666675,2021-08-02
581,62,2962,2316663,0.020931802835921675,10333.333333333334,20441000.000000007,2021-08-03
582,70,2751,2319414,0.02544529262086514,11666.666666666666,20452666.666666675,2021-08-04
583,76,3014,2322428,0.025215660252156602,12666.666666666666,20465333.333333343,2021-08-05
584,57,3318,2325746,0.017179023508137433,9500.0,20474833.333333343,2021-08-06
585,54,2662,2328408,0.0202854996243426,9000.0,20483833.333333343,2021-08-07
586,62,2850,2331258,0.02175438596491228,10333.333333333334,20494166.666666675,2021-08-08
587,61,3492,2334750,0.017468499427262314,10166.666666666666,20504333.333333343,2021-08-09
588,73,3519,2338269,0.020744529695936344,12166.666666666666,20516500.00000001,2021-08-10
589,30,2385,2340654,0.012578616352201259,5000.0,20521500.00000001,2021-08-11
590,37,2677,2343331,0.013821441912588718,6166.666666666667,20527666.66666668,2021-08-12
591,99,5712,2349043,0.017331932773109245,16500.0,20544166.66666668,2021-08-13
