,cases,deaths,cases_cum,case_adj,case_adj_cum,date
0,1,0,1,0.0,0.0,2020-02-26
1,5,0,6,0.0,0.0,2020-02-27
2,2,0,8,0.0,0.0,2020-02-28
3,6,0,14,0.0,0.0,2020-02-29
4,2,0,16,0.0,0.0,2020-03-01
5,2,0,18,0.0,0.0,2020-03-02
6,1,0,19,0.0,0.0,2020-03-03
7,1,0,20,0.0,0.0,2020-03-04
8,1,0,21,0.0,0.0,2020-03-05
9,1,0,22,0.0,0.0,2020-03-06
10,1,0,23,0.0,0.0,2020-03-07
11,1,0,24,0.0,0.0,2020-03-08
12,1,0,25,0.0,0.0,2020-03-09
13,1,0,26,0.0,0.0,2020-03-10
14,1,0,27,0.0,0.0,2020-03-11
15,2,0,29,0.0,0.0,2020-03-12
16,1,0,30,0.0,0.0,2020-03-13
17,1,0,31,0.0,0.0,2020-03-14
18,1,0,32,0.0,0.0,2020-03-15
19,1,0,33,0.0,0.0,2020-03-16
20,1,1,34,166.66666666666666,166.66666666666666,2020-03-17
21,3,1,37,166.66666666666666,333.3333333333333,2020-03-18
22,2,0,39,0.0,333.3333333333333,2020-03-19
23,1,1,40,166.66666666666666,500.0,2020-03-20
24,6,0,46,0.0,500.0,2020-03-21
25,5,0,51,0.0,500.0,2020-03-22
26,4,1,55,166.66666666666666,666.6666666666666,2020-03-23
27,6,2,61,333.3333333333333,1000.0,2020-03-24
28,16,4,77,666.6666666666666,1666.6666666666665,2020-03-25
29,36,1,113,166.66666666666666,1833.3333333333333,2020-03-26
30,32,1,145,166.66666666666666,2000.0,2020-03-27
31,21,1,166,166.66666666666666,2166.6666666666665,2020-03-28
32,52,2,218,333.3333333333333,2500.0,2020-03-29
33,29,1,247,166.66666666666666,2666.6666666666665,2020-03-30
34,31,2,278,333.3333333333333,3000.0,2020-03-31
35,32,3,310,500.0,3500.0,2020-04-01
36,41,2,351,333.3333333333333,3833.3333333333335,2020-04-02
37,100,3,451,500.0,4333.333333333334,2020-04-03
38,51,3,502,500.0,4833.333333333334,2020-04-04
39,91,10,593,1666.6666666666667,6500.000000000001,2020-04-05
40,124,15,717,2500.0,9000.0,2020-04-06
41,130,12,847,2000.0,11000.0,2020-04-07
42,189,9,1036,1500.0,12500.0,2020-04-08
43,212,17,1248,2833.3333333333335,15333.333333333334,2020-04-09
44,171,15,1419,2500.0,17833.333333333336,2020-04-10
45,206,12,1625,2000.0,19833.333333333336,2020-04-11
46,190,23,1815,3833.333333333333,23666.666666666668,2020-04-12
47,410,42,2225,7000.0,30666.666666666668,2020-04-13
48,214,22,2439,3666.6666666666665,34333.333333333336,2020-04-14
49,275,22,2714,3666.6666666666665,38000.0,2020-04-15
50,386,51,3100,8500.0,46500.0,2020-04-16
51,305,24,3405,4000.0,50500.0,2020-04-17
52,5892,21,9297,3500.0,54000.0,2020-04-18
53,365,36,9662,6000.0,60000.0,2020-04-19
54,329,45,9991,7500.0,67500.0,2020-04-20
55,291,22,10282,3666.6666666666665,71166.66666666667,2020-04-21
56,277,35,10559,5833.333333333333,77000.0,2020-04-22
57,435,34,10994,5666.666666666667,82666.66666666667,2020-04-23
58,308,49,11302,8166.666666666666,90833.33333333334,2020-04-24
59,572,65,11874,10833.333333333334,101666.66666666667,2020-04-25
60,384,36,12258,6000.0,107666.66666666667,2020-04-26
61,380,46,12638,7666.666666666666,115333.33333333334,2020-04-27
62,520,47,13158,7833.333333333333,123166.66666666667,2020-04-28
63,10281,45,23439,7500.0,130666.66666666667,2020-04-29
64,474,47,23913,7833.333333333333,138500.0,2020-04-30
65,367,41,24280,6833.333333333333,145333.33333333334,2020-05-01
66,432,48,24712,8000.0,153333.33333333334,2020-05-02
67,2724,53,27436,8833.333333333334,162166.6666666667,2020-05-03
68,743,81,28179,13500.0,175666.6666666667,2020-05-04
69,490,37,28669,6166.666666666667,181833.33333333334,2020-05-05
70,619,54,29288,9000.0,190833.33333333334,2020-05-06
71,1392,71,30680,11833.333333333334,202666.6666666667,2020-05-07
72,644,74,31324,12333.333333333334,215000.00000000003,2020-05-08
73,800,83,32124,13833.333333333334,228833.33333333337,2020-05-09
74,2401,80,34525,13333.333333333334,242166.66666666672,2020-05-10
75,783,94,35308,15666.666666666666,257833.33333333337,2020-05-11
76,832,88,36140,14666.666666666666,272500.00000000006,2020-05-12
77,753,81,36893,13500.0,286000.00000000006,2020-05-13
78,1303,156,38196,26000.0,312000.00000000006,2020-05-14
79,689,82,38885,13666.666666666666,325666.66666666674,2020-05-15
80,868,89,39753,14833.333333333332,340500.00000000006,2020-05-16
81,851,101,40604,16833.333333333332,357333.3333333334,2020-05-17
82,1011,92,41615,15333.333333333332,372666.6666666667,2020-05-18
83,975,77,42590,12833.333333333334,385500.0,2020-05-19
84,911,112,43501,18666.666666666668,404166.6666666667,2020-05-20
85,1165,108,44666,18000.0,422166.6666666667,2020-05-21
86,1016,109,45682,18166.666666666668,440333.3333333334,2020-05-22
87,980,86,46662,14333.333333333334,454666.6666666667,2020-05-23
88,10979,121,57641,20166.666666666668,474833.3333333334,2020-05-24
89,1937,200,59578,33333.333333333336,508166.6666666667,2020-05-25
90,1486,142,61064,23666.666666666668,531833.3333333334,2020-05-26
91,1179,118,62243,19666.666666666668,551500.0,2020-05-27
92,1386,136,63629,22666.666666666668,574166.6666666666,2020-05-28
93,1687,156,65316,26000.0,600166.6666666666,2020-05-29
94,1191,108,66507,18000.0,618166.6666666666,2020-05-30
95,1378,130,67885,21666.666666666668,639833.3333333333,2020-05-31
96,1591,136,69476,22666.666666666668,662499.9999999999,2020-06-01
97,1343,153,70819,25500.0,687999.9999999999,2020-06-02
98,2333,193,73152,32166.666666666664,720166.6666666665,2020-06-03
99,1828,150,74980,25000.0,745166.6666666665,2020-06-04
100,1720,166,76700,27666.666666666668,772833.3333333331,2020-06-05
101,1794,147,78494,24500.0,797333.3333333331,2020-06-06
102,1789,147,80283,24500.0,821833.3333333331,2020-06-07
103,2644,191,82927,31833.333333333332,853666.6666666665,2020-06-08
104,1773,162,84700,27000.0,880666.6666666665,2020-06-09
105,1818,150,86518,25000.0,905666.6666666665,2020-06-10
106,2520,165,89038,27500.0,933166.6666666665,2020-06-11
107,2078,140,91116,23333.333333333332,956499.9999999999,2020-06-12
108,3236,235,94352,39166.666666666664,995666.6666666665,2020-06-13
109,1930,143,96282,23833.333333333332,1019499.9999999999,2020-06-14
110,2344,162,98626,27000.0,1046499.9999999999,2020-06-15
111,2023,156,100649,26000.0,1072500.0,2020-06-16
112,1886,178,102535,29666.666666666664,1102166.6666666667,2020-06-17
113,3103,222,105638,37000.0,1139166.6666666667,2020-06-18
114,2128,177,107766,29500.0,1168666.6666666667,2020-06-19
115,2077,168,109843,28000.0,1196666.6666666667,2020-06-20
116,2349,147,112192,24500.0,1221166.6666666667,2020-06-21
117,2335,136,114527,22666.666666666668,1243833.3333333335,2020-06-22
118,2160,137,116687,22833.333333333332,1266666.6666666667,2020-06-23
119,1832,134,118519,22333.333333333332,1289000.0,2020-06-24
120,4101,281,122620,46833.333333333336,1335833.3333333333,2020-06-25
121,2646,175,125266,29166.666666666664,1365000.0,2020-06-26
122,2529,173,127795,28833.333333333332,1393833.3333333333,2020-06-27
123,2531,164,130326,27333.333333333332,1421166.6666666665,2020-06-28
124,3065,173,133391,28833.333333333332,1449999.9999999998,2020-06-29
125,2601,174,135992,29000.0,1478999.9999999998,2020-06-30
126,2133,164,138125,27333.333333333332,1506333.333333333,2020-07-01
127,3106,186,141231,31000.0,1537333.333333333,2020-07-02
128,2743,172,143974,28666.666666666668,1565999.9999999998,2020-07-03
129,3844,202,147818,33666.666666666664,1599666.6666666665,2020-07-04
130,2455,145,150273,24166.666666666668,1623833.3333333333,2020-07-05
131,3323,181,153596,30166.666666666664,1654000.0,2020-07-06
132,2910,165,156506,27500.0,1681500.0,2020-07-07
133,3154,169,159660,28166.666666666668,1709666.6666666667,2020-07-08
134,5402,197,165062,32833.333333333336,1742500.0,2020-07-09
135,4015,167,169077,27833.333333333332,1770333.3333333333,2020-07-10
136,3548,134,172625,22333.333333333332,1792666.6666666665,2020-07-11
137,4145,177,176770,29500.0,1822166.6666666665,2020-07-12
138,4227,189,180997,31500.0,1853666.6666666665,2020-07-13
139,4482,207,185479,34500.0,1888166.6666666665,2020-07-14
140,2764,135,188243,22500.0,1910666.6666666665,2020-07-15
141,4114,190,192357,31666.666666666664,1942333.3333333333,2020-07-16
142,3652,154,196009,25666.666666666668,1968000.0,2020-07-17
143,3500,156,199509,26000.0,1994000.0,2020-07-18
144,4292,190,203801,31666.666666666664,2025666.6666666667,2020-07-19
145,4257,185,208058,30833.333333333332,2056500.0,2020-07-20
146,3016,141,211074,23500.0,2080000.0,2020-07-21
147,3314,150,214388,25000.0,2105000.0,2020-07-22
148,4528,147,218916,24500.0,2129500.0,2020-07-23
149,4435,192,223351,32000.0,2161500.0,2020-07-24
150,6019,242,229370,40333.333333333336,2201833.3333333335,2020-07-25
151,4383,191,233753,31833.333333333332,2233666.666666667,2020-07-26
152,4523,193,238276,32166.666666666664,2265833.3333333335,2020-07-27
153,3562,194,241838,32333.333333333332,2298166.666666667,2020-07-28
154,4101,181,245939,30166.666666666664,2328333.3333333335,2020-07-29
155,4937,179,250876,29833.333333333332,2358166.666666667,2020-07-30
156,4736,193,255612,32166.666666666664,2390333.3333333335,2020-07-31
157,4259,170,259871,28333.333333333332,2418666.666666667,2020-08-01
158,3870,149,263741,24833.333333333332,2443500.0000000005,2020-08-02
159,5893,275,269634,45833.333333333336,2489333.333333334,2020-08-03
160,3647,158,273281,26333.333333333332,2515666.6666666674,2020-08-04
161,3527,169,276808,28166.666666666668,2543833.333333334,2020-08-05
162,5071,188,281879,31333.333333333332,2575166.6666666674,2020-08-06
163,4366,178,286245,29666.666666666664,2604833.333333334,2020-08-07
164,4597,183,290842,30500.0,2635333.333333334,2020-08-08
165,4010,169,294852,28166.666666666668,2663500.0000000005,2020-08-09
166,4887,200,299739,33333.333333333336,2696833.333333334,2020-08-10
167,4075,175,303814,29166.666666666664,2726000.0000000005,2020-08-11
168,3496,167,307310,27833.333333333332,2753833.333333334,2020-08-12
169,6195,260,313505,43333.333333333336,2797166.6666666674,2020-08-13
170,3821,137,317326,22833.333333333332,2820000.000000001,2020-08-14
171,4055,152,321381,25333.333333333332,2845333.3333333344,2020-08-15
172,5162,146,326543,24333.333333333332,2869666.666666668,2020-08-16
173,4083,137,330626,22833.333333333332,2892500.0000000014,2020-08-17
174,3998,148,334624,24666.666666666668,2917166.666666668,2020-08-18
175,3407,152,338031,25333.333333333332,2942500.0000000014,2020-08-19
176,5109,194,343140,32333.333333333332,2974833.333333335,2020-08-20
177,4227,135,347367,22500.0,2997333.333333335,2020-08-21
178,3597,136,350964,22666.666666666668,3020000.0000000014,2020-08-22
179,4072,116,355036,19333.333333333332,3039333.333333335,2020-08-23
180,4355,136,359391,22666.666666666668,3062000.0000000014,2020-08-24
181,5583,200,364974,33333.333333333336,3095333.333333335,2020-08-25
182,4250,145,369224,24166.666666666668,3119500.0000000014,2020-08-26
183,4601,167,373825,27833.333333333332,3147333.333333335,2020-08-27
184,3819,136,377644,22666.666666666668,3170000.0000000014,2020-08-28
185,4333,158,381977,26333.333333333332,3196333.333333335,2020-08-29
186,4070,125,386047,20833.333333333332,3217166.6666666684,2020-08-30
187,4589,149,390636,24833.333333333332,3242000.000000002,2020-08-31
188,3802,150,394438,25000.0,3267000.000000002,2020-09-01
189,3329,124,397767,20666.666666666668,3287666.6666666684,2020-09-02
190,5849,196,403616,32666.666666666664,3320333.333333335,2020-09-03
191,4034,122,407650,20333.333333333332,3340666.6666666684,2020-09-04
192,4140,153,411790,25500.0,3366166.6666666684,2020-09-05
193,3787,154,415577,25666.666666666668,3391833.333333335,2020-09-06
194,4351,135,419928,22500.0,3414333.333333335,2020-09-07
195,4104,140,424032,23333.333333333332,3437666.6666666684,2020-09-08
196,3048,118,427080,19666.666666666668,3457333.333333335,2020-09-09
197,4452,140,431532,23333.333333333332,3480666.6666666684,2020-09-10
198,3748,140,435280,23333.333333333332,3504000.000000002,2020-09-11
199,3295,95,438575,15833.333333333332,3519833.3333333354,2020-09-12
200,5243,209,443818,34833.333333333336,3554666.666666669,2020-09-13
201,3811,127,447629,21166.666666666668,3575833.3333333354,2020-09-14
202,3168,105,450797,17500.0,3593333.3333333354,2020-09-15
203,2907,93,453704,15500.0,3608833.3333333354,2020-09-16
204,4114,115,457818,19166.666666666668,3628000.000000002,2020-09-17
205,4012,129,461830,21500.0,3649500.000000002,2020-09-18
206,3546,103,465376,17166.666666666668,3666666.6666666684,2020-09-19
207,3521,110,468897,18333.333333333332,3685000.000000002,2020-09-20
208,4286,128,473183,21333.333333333332,3706333.3333333354,2020-09-21
209,2576,86,475759,14333.333333333334,3720666.666666669,2020-09-22
210,2645,108,478404,18000.0,3738666.666666669,2020-09-23
211,3731,89,482135,14833.333333333332,3753500.0000000023,2020-09-24
212,4583,163,486718,27166.666666666668,3780666.666666669,2020-09-25
213,3337,92,490055,15333.333333333332,3796000.0000000023,2020-09-26
214,3024,108,493079,18000.0,3814000.0000000023,2020-09-27
215,3315,103,496394,17166.666666666668,3831166.666666669,2020-09-28
216,2750,116,499144,19333.333333333332,3850500.0000000023,2020-09-29
217,2301,91,501445,15166.666666666666,3865666.666666669,2020-09-30
218,2814,114,504259,19000.0,3884666.666666669,2020-10-01
219,3391,104,507650,17333.333333333332,3902000.0000000023,2020-10-02
220,3204,86,510854,14333.333333333334,3916333.333333336,2020-10-03
221,3732,119,514586,19833.333333333332,3936166.6666666693,2020-10-04
222,3386,96,517972,16000.0,3952166.6666666693,2020-10-05
223,2707,96,520679,16000.0,3968166.6666666693,2020-10-06
224,2478,113,523157,18833.333333333332,3987000.000000003,2020-10-07
225,3390,88,526547,14666.666666666666,4001666.6666666693,2020-10-08
226,3140,89,529687,14833.333333333332,4016500.000000003,2020-10-09
227,2610,95,532297,15833.333333333332,4032333.3333333363,2020-10-10
228,2665,107,534962,17833.333333333332,4050166.66666667,2020-10-11
229,2904,78,537866,13000.0,4063166.66666667,2020-10-12
230,2329,67,540195,11166.666666666666,4074333.3333333363,2020-10-13
231,2817,118,543012,19666.666666666668,4094000.000000003,2020-10-14
232,3041,81,546053,13500.0,4107500.000000003,2020-10-15
233,2655,65,548708,10833.333333333334,4118333.3333333363,2020-10-16
234,2487,74,551195,12333.333333333334,4130666.66666667,2020-10-17
235,2507,80,553702,13333.333333333334,4144000.0000000033,2020-10-18
236,3067,91,556769,15166.666666666666,4159166.66666667,2020-10-19
237,2036,58,558805,9666.666666666666,4168833.3333333363,2020-10-20
238,1997,90,560802,15000.0,4183833.3333333363,2020-10-21
239,2735,79,563537,13166.666666666666,4197000.000000003,2020-10-22
240,2216,83,565753,13833.333333333334,4210833.333333336,2020-10-23
241,2269,73,568022,12166.666666666666,4223000.000000003,2020-10-24
242,3264,120,571286,20000.0,4243000.000000003,2020-10-25
243,2485,86,573771,14333.333333333334,4257333.333333336,2020-10-26
244,2067,72,575838,12000.0,4269333.333333336,2020-10-27
245,1797,64,577635,10666.666666666666,4280000.000000003,2020-10-28
246,2915,72,580550,12000.0,4292000.000000003,2020-10-29
247,2289,73,582839,12166.666666666666,4304166.66666667,2020-10-30
248,2303,70,585142,11666.666666666666,4315833.333333337,2020-10-31
249,2525,71,587667,11833.333333333334,4327666.66666667,2020-11-01
250,2877,66,590544,11000.0,4338666.66666667,2020-11-02
251,3125,87,593669,14500.0,4353166.66666667,2020-11-03
252,1756,57,595425,9500.0,4362666.66666667,2020-11-04
253,2381,69,597806,11500.0,4374166.66666667,2020-11-05
254,2686,55,600492,9166.666666666666,4383333.333333337,2020-11-06
255,2543,61,603035,10166.666666666666,4393500.000000004,2020-11-07
256,3054,72,606089,12000.0,4405500.000000004,2020-11-08
257,3068,65,609157,10833.333333333334,4416333.333333337,2020-11-09
258,2214,60,611371,10000.0,4426333.333333337,2020-11-10
259,2254,55,613625,9166.666666666666,4435500.000000004,2020-11-11
260,3180,78,616805,13000.0,4448500.000000004,2020-11-12
261,3213,83,620018,13833.333333333334,4462333.333333337,2020-11-13
262,2584,73,622602,12166.666666666666,4474500.000000004,2020-11-14
263,2870,55,625472,9166.666666666666,4483666.666666671,2020-11-15
264,3111,62,628583,10333.333333333334,4494000.000000004,2020-11-16
265,2118,64,630701,10666.666666666666,4504666.666666671,2020-11-17
266,2398,73,633099,12166.666666666666,4516833.333333338,2020-11-18
267,3072,67,636171,11166.666666666666,4528000.000000005,2020-11-19
268,2678,65,638849,10833.333333333334,4538833.333333338,2020-11-20
269,2901,57,641750,9500.0,4548333.333333338,2020-11-21
270,2864,62,644614,10333.333333333334,4558666.666666671,2020-11-22
271,2833,85,647447,14166.666666666666,4572833.333333338,2020-11-23
272,2320,58,649767,9666.666666666666,4582500.000000005,2020-11-24
273,3675,130,653442,21666.666666666668,4604166.666666672,2020-11-25
274,3261,72,656703,12000.0,4616166.666666672,2020-11-26
275,3566,76,660269,12666.666666666666,4628833.333333339,2020-11-27
276,3516,90,663785,15000.0,4643833.333333339,2020-11-28
277,3665,107,667450,17833.333333333332,4661666.666666672,2020-11-29
278,3829,95,671279,15833.333333333332,4677500.000000005,2020-11-30
279,3342,105,674621,17500.0,4695000.000000005,2020-12-01
280,3352,119,677973,19833.333333333332,4714833.333333338,2020-12-02
281,4502,114,682475,19000.0,4733833.333333338,2020-12-03
282,4909,141,687384,23500.0,4757333.333333338,2020-12-04
283,3927,100,691311,16666.666666666668,4774000.000000005,2020-12-05
284,3972,131,695283,21833.333333333332,4795833.333333338,2020-12-06
285,4635,122,699918,20333.333333333332,4816166.666666671,2020-12-07
286,4165,124,704083,20666.666666666668,4836833.333333338,2020-12-08
287,4880,136,708963,22666.666666666668,4859500.000000005,2020-12-09
288,5520,126,714483,21000.0,4880500.000000005,2020-12-10
289,4864,128,719347,21333.333333333332,4901833.333333338,2020-12-11
290,5087,138,724434,23000.0,4924833.333333338,2020-12-12
291,5417,140,729851,23333.333333333332,4948166.666666671,2020-12-13
292,7218,230,737069,38333.333333333336,4986500.000000004,2020-12-14
293,5172,110,742241,18333.333333333332,5004833.333333337,2020-12-15
294,5163,144,747404,24000.0,5028833.333333337,2020-12-16
295,6942,181,754346,30166.666666666664,5059000.000000004,2020-12-17
296,5616,159,759962,26500.0,5085500.000000004,2020-12-18
297,6439,184,766401,30666.666666666664,5116166.666666671,2020-12-19
298,5753,152,772154,25333.333333333332,5141500.000000004,2020-12-20
299,6251,160,778405,26666.666666666668,5168166.666666671,2020-12-21
300,5461,166,783866,27666.666666666668,5195833.333333338,2020-12-22
301,4814,152,788680,25333.333333333332,5221166.666666671,2020-12-23
302,7697,235,796377,39166.666666666664,5260333.333333338,2020-12-24
303,8093,304,804470,50666.666666666664,5311000.000000005,2020-12-25
304,6060,166,810530,27666.666666666668,5338666.666666672,2020-12-26
305,5965,201,816495,33500.0,5372166.666666672,2020-12-27
306,6669,204,823164,34000.0,5406166.666666672,2020-12-28
307,5895,185,829059,30833.333333333332,5437000.000000005,2020-12-29
308,5123,159,834182,26500.0,5463500.000000005,2020-12-30
309,7137,201,841319,33500.0,5497000.000000005,2020-12-31
310,5720,166,847039,27666.666666666668,5524666.666666672,2021-01-01
311,5811,174,852850,29000.0,5553666.666666672,2021-01-02
312,7172,244,860022,40666.666666666664,5594333.333333339,2021-01-03
313,6129,176,866151,29333.333333333332,5623666.666666672,2021-01-04
314,5611,204,871762,34000.0,5657666.666666672,2021-01-05
315,5015,166,876777,27666.666666666668,5685333.333333339,2021-01-06
316,7120,177,883897,29500.0,5714833.333333339,2021-01-07
317,6179,182,890076,30333.333333333332,5745166.666666672,2021-01-08
318,5293,151,895369,25166.666666666668,5770333.333333339,2021-01-09
319,5318,158,900687,26333.333333333332,5796666.666666672,2021-01-10
320,5951,163,906638,27166.666666666668,5823833.333333339,2021-01-11
321,4531,165,911169,27500.0,5851333.333333339,2021-01-12
322,5054,235,916223,39166.666666666664,5890500.000000006,2021-01-13
323,5505,151,921728,25166.666666666668,5915666.666666673,2021-01-14
324,4867,124,926595,20666.666666666668,5936333.33333334,2021-01-15
325,5552,193,932147,32166.666666666664,5968500.0000000065,2021-01-16
326,5271,176,937418,29333.333333333332,5997833.33333334,2021-01-17
327,5328,212,942746,35333.333333333336,6033166.666666673,2021-01-18
328,5484,190,948230,31666.666666666664,6064833.33333334,2021-01-19
329,5095,189,953325,31500.0,6096333.33333334,2021-01-20
330,6522,215,959847,35833.333333333336,6132166.666666673,2021-01-21
331,5209,144,965056,24000.0,6156166.666666673,2021-01-22
332,6085,195,971141,32500.0,6188666.666666673,2021-01-23
333,5773,177,976914,29500.0,6218166.666666673,2021-01-24
334,8541,314,985455,52333.333333333336,6270500.000000006,2021-01-25
335,7257,198,992712,33000.0,6303500.000000006,2021-01-26
336,6897,182,999609,30333.333333333332,6333833.333333339,2021-01-27
337,9120,222,1008729,37000.0,6370833.333333339,2021-01-28
338,7355,216,1016084,36000.0,6406833.333333339,2021-01-29
339,6597,199,1022681,33166.666666666664,6440000.000000006,2021-01-30
340,6465,194,1029146,32333.333333333332,6472333.333333339,2021-01-31
341,7129,195,1036275,32500.0,6504833.333333339,2021-02-01
342,5923,170,1042198,28333.333333333332,6533166.666666672,2021-02-02
343,6844,246,1049042,41000.0,6574166.666666672,2021-02-03
344,7151,198,1056193,33000.0,6607166.666666672,2021-02-04
345,6239,192,1062432,32000.0,6639166.666666672,2021-02-05
346,5609,151,1068041,25166.666666666668,6664333.333333339,2021-02-06
347,6161,184,1074202,30666.666666666664,6695000.000000006,2021-02-07
348,7061,203,1081263,33833.333333333336,6728833.333333339,2021-02-08
349,5022,171,1086285,28500.0,6757333.333333339,2021-02-09
350,4946,164,1091231,27333.333333333332,6784666.666666672,2021-02-10
351,7010,163,1098241,27166.666666666668,6811833.333333339,2021-02-11
352,5739,149,1103980,24833.333333333332,6836666.666666672,2021-02-12
353,6327,210,1110307,35000.0,6871666.666666672,2021-02-13
354,5640,173,1115947,28833.333333333332,6900500.000000005,2021-02-14
355,6096,175,1122043,29166.666666666664,6929666.666666672,2021-02-15
356,4767,133,1126810,22166.666666666668,6951833.333333339,2021-02-16
357,4818,162,1131628,27000.0,6978833.333333339,2021-02-17
358,6234,196,1137862,32666.666666666664,7011500.000000006,2021-02-18
359,4898,158,1142760,26333.333333333332,7037833.333333339,2021-02-19
360,4698,164,1147458,27333.333333333332,7065166.666666672,2021-02-20
361,5003,155,1152461,25833.333333333332,7091000.000000005,2021-02-21
362,4924,150,1157385,25000.0,7116000.000000005,2021-02-22
363,4201,149,1161586,24833.333333333332,7140833.333333338,2021-02-23
364,4337,170,1165923,28333.333333333332,7169166.666666671,2021-02-24
365,7237,298,1173160,49666.666666666664,7218833.333333338,2021-02-25
366,5182,216,1178342,36000.0,7254833.333333338,2021-02-26
367,5082,192,1183424,32000.0,7286833.333333338,2021-02-27
368,4920,185,1188344,30833.333333333332,7317666.666666671,2021-02-28
369,6089,228,1194433,38000.0,7355666.666666671,2021-03-01
370,5026,212,1199459,35333.333333333336,7391000.000000004,2021-03-02
371,4913,189,1204372,31500.0,7422500.000000004,2021-03-03
372,6454,250,1210826,41666.666666666664,7464166.666666671,2021-03-04
373,5539,230,1216365,38333.333333333336,7502500.000000004,2021-03-05
374,6454,326,1222819,54333.333333333336,7556833.333333337,2021-03-06
375,6075,261,1228894,43500.0,7600333.333333337,2021-03-07
376,6714,313,1235608,52166.666666666664,7652500.000000004,2021-03-08
377,6034,283,1241642,47166.666666666664,7699666.666666671,2021-03-09
378,6259,309,1247901,51500.0,7751166.666666671,2021-03-10
379,8792,403,1256693,67166.66666666667,7818333.333333338,2021-03-11
380,7067,329,1263760,54833.333333333336,7873166.666666671,2021-03-12
381,7311,349,1271071,58166.666666666664,7931333.333333338,2021-03-13
382,8186,392,1279257,65333.33333333333,7996666.666666671,2021-03-14
383,8872,385,1288129,64166.666666666664,8060833.333333338,2021-03-15
384,9542,525,1297671,87500.0,8148333.333333338,2021-03-16
385,7463,416,1305134,69333.33333333333,8217666.666666671,2021-03-17
386,10023,481,1315157,80166.66666666667,8297833.333333338,2021-03-18
387,8426,374,1323583,62333.33333333333,8360166.666666671,2021-03-19
388,8284,418,1331867,69666.66666666667,8429833.333333338,2021-03-20
389,8976,486,1340843,81000.0,8510833.333333338,2021-03-21
390,9451,489,1350294,81500.0,8592333.333333338,2021-03-22
391,8418,447,1358712,74500.0,8666833.333333338,2021-03-23
392,10192,612,1368904,102000.0,8768833.333333338,2021-03-24
393,14259,985,1383163,164166.66666666666,8933000.000000004,2021-03-25
394,9619,603,1392782,100500.0,9033500.000000004,2021-03-26
395,9443,578,1402225,96333.33333333333,9129833.333333338,2021-03-27
396,9581,575,1411806,95833.33333333333,9225666.666666672,2021-03-28
397,11881,671,1423687,111833.33333333333,9337500.000000006,2021-03-29
398,9643,543,1433330,90500.0,9428000.000000006,2021-03-30
399,8870,597,1442200,99500.0,9527500.000000006,2021-03-31
400,12457,756,1454657,126000.0,9653500.000000006,2021-04-01
401,10047,630,1464704,105000.0,9758500.000000006,2021-04-02
402,12011,923,1476715,153833.33333333334,9912333.33333334,2021-04-03
403,10163,620,1486878,103333.33333333333,10015666.666666673,2021-04-04
404,11611,707,1498489,117833.33333333333,10133500.000000007,2021-04-05
405,9971,645,1508460,107500.0,10241000.000000007,2021-04-06
406,9471,636,1517931,106000.0,10347000.000000007,2021-04-07
407,13131,843,1531062,140500.0,10487500.000000007,2021-04-08
408,9873,677,1540935,112833.33333333333,10600333.333333341,2021-04-09
409,9662,656,1550597,109333.33333333333,10709666.666666675,2021-04-10
410,10214,693,1560811,115500.0,10825166.666666675,2021-04-11
411,11122,658,1571933,109666.66666666667,10934833.333333341,2021-04-12
412,11044,858,1582977,143000.0,11077833.333333341,2021-04-13
413,8195,538,1591172,89666.66666666667,11167500.000000007,2021-04-14
414,10555,633,1601727,105500.0,11273000.000000007,2021-04-15
415,8620,568,1610347,94666.66666666667,11367666.666666673,2021-04-16
416,7824,515,1618171,85833.33333333333,11453500.000000007,2021-04-17
417,8923,639,1627094,106500.0,11560000.000000007,2021-04-18
418,8535,531,1635629,88500.0,11648500.000000007,2021-04-19
419,6988,480,1642617,80000.0,11728500.000000007,2021-04-20
420,6747,510,1649364,85000.0,11813500.000000007,2021-04-21
421,7662,483,1657026,80500.0,11894000.000000007,2021-04-22
422,6495,453,1663521,75500.0,11969500.000000007,2021-04-23
423,6337,407,1669858,67833.33333333333,12037333.333333341,2021-04-24
424,9435,758,1679293,126333.33333333333,12163666.666666675,2021-04-25
425,6597,434,1685890,72333.33333333333,12236000.00000001,2021-04-26
426,6426,418,1692316,69666.66666666667,12305666.666666675,2021-04-27
427,6533,426,1698849,71000.0,12376666.666666675,2021-04-28
428,8338,515,1707187,85833.33333333333,12462500.00000001,2021-04-29
429,6503,389,1713690,64833.33333333333,12527333.333333343,2021-04-30
430,6503,391,1720193,65166.666666666664,12592500.00000001,2021-05-01
431,6971,413,1727164,68833.33333333333,12661333.333333343,2021-05-02
432,7278,417,1734442,69500.0,12730833.333333343,2021-05-03
433,7583,557,1742025,92833.33333333333,12823666.666666677,2021-05-04
434,5588,311,1747613,51833.333333333336,12875500.000000011,2021-05-05
435,7886,371,1755499,61833.33333333333,12937333.333333345,2021-05-06
436,6236,336,1761735,56000.0,12993333.333333345,2021-05-07
437,6245,361,1767980,60166.666666666664,13053500.000000011,2021-05-08
438,6696,402,1774676,67000.0,13120500.000000011,2021-05-09
439,6594,312,1781270,52000.0,13172500.000000011,2021-05-10
440,5527,306,1786797,51000.0,13223500.000000011,2021-05-11
441,5530,287,1792327,47833.333333333336,13271333.333333345,2021-05-12
442,7111,326,1799438,54333.333333333336,13325666.66666668,2021-05-13
443,7459,438,1806897,73000.0,13398666.66666668,2021-05-14
444,5375,296,1812272,49333.333333333336,13448000.000000013,2021-05-15
445,6181,299,1818453,49833.333333333336,13497833.333333347,2021-05-16
446,6534,310,1824987,51666.666666666664,13549500.000000013,2021-05-17
447,5821,279,1830808,46500.0,13596000.000000013,2021-05-18
448,5986,338,1836794,56333.333333333336,13652333.333333347,2021-05-19
449,7013,336,1843807,56000.0,13708333.333333347,2021-05-20
450,5575,289,1849382,48166.666666666664,13756500.000000013,2021-05-21
451,5794,337,1855176,56166.666666666664,13812666.66666668,2021-05-22
452,5162,257,1860338,42833.333333333336,13855500.000000013,2021-05-23
453,7172,358,1867510,59666.666666666664,13915166.66666668,2021-05-24
454,7821,488,1875331,81333.33333333333,13996500.000000013,2021-05-25
455,6197,330,1881528,55000.0,14051500.000000013,2021-05-26
456,7526,344,1889054,57333.333333333336,14108833.333333347,2021-05-27
457,6223,298,1895277,49666.666666666664,14158500.000000013,2021-05-28
458,6923,418,1902200,69666.66666666667,14228166.66666668,2021-05-29
459,6362,317,1908562,52833.333333333336,14281000.000000013,2021-05-30
460,7290,359,1915852,59833.33333333333,14340833.333333347,2021-05-31
461,6723,316,1922575,52666.666666666664,14393500.000000013,2021-06-01
462,6793,321,1929368,53500.0,14447000.000000013,2021-06-02
463,10231,537,1939599,89500.0,14536500.000000013,2021-06-03
464,6777,318,1946376,53000.0,14589500.000000013,2021-06-04
465,7066,361,1953442,60166.666666666664,14649666.66666668,2021-06-05
466,7217,356,1960659,59333.33333333333,14709000.000000013,2021-06-06
467,8507,391,1969166,65166.666666666664,14774166.66666668,2021-06-07
468,8630,424,1977796,70666.66666666667,14844833.333333345,2021-06-08
469,7141,338,1984937,56333.333333333336,14901166.66666668,2021-06-09
470,9260,375,1994197,62500.0,14963666.66666668,2021-06-10
471,8049,399,2002246,66500.0,15030166.66666668,2021-06-11
472,7446,340,2009692,56666.666666666664,15086833.333333345,2021-06-12
473,9159,475,2018851,79166.66666666667,15166000.000000011,2021-06-13
474,8511,365,2027362,60833.33333333333,15226833.333333345,2021-06-14
475,7448,352,2034810,58666.666666666664,15285500.000000011,2021-06-15
476,7194,326,2042004,54333.333333333336,15339833.333333345,2021-06-16
477,9588,352,2051592,58666.666666666664,15398500.000000011,2021-06-17
478,9240,401,2060832,66833.33333333333,15465333.333333345,2021-06-18
479,7984,357,2068816,59500.0,15524833.333333345,2021-06-19
480,7975,336,2076791,56000.0,15580833.333333345,2021-06-20
481,9051,372,2085842,62000.0,15642833.333333345,2021-06-21
482,7194,294,2093036,49000.0,15691833.333333345,2021-06-22
483,6903,335,2099939,55833.333333333336,15747666.66666668,2021-06-23
484,8501,338,2108440,56333.333333333336,15804000.000000013,2021-06-24
485,9511,483,2117951,80500.0,15884500.000000013,2021-06-25
486,7977,322,2125928,53666.666666666664,15938166.66666668,2021-06-26
487,7194,297,2133122,49500.0,15987666.66666668,2021-06-27
488,8318,276,2141440,46000.0,16033666.66666668,2021-06-28
489,7701,289,2149141,48166.666666666664,16081833.333333345,2021-06-29
490,6991,279,2156132,46500.0,16128333.333333345,2021-06-30
491,8439,314,2164571,52333.333333333336,16180666.66666668,2021-07-01
492,6922,262,2171493,43666.666666666664,16224333.333333345,2021-07-02
493,6503,235,2177996,39166.666666666664,16263500.000000011,2021-07-03
494,7735,363,2185731,60500.0,16324000.000000011,2021-07-04
495,6975,236,2192706,39333.333333333336,16363333.333333345,2021-07-05
496,6171,243,2198877,40500.0,16403833.333333345,2021-07-06
497,5782,243,2204659,40500.0,16444333.333333345,2021-07-07
498,7539,288,2212198,48000.0,16492333.333333345,2021-07-08
499,6370,225,2218568,37500.0,16529833.333333345,2021-07-09
500,5782,203,2224350,33833.333333333336,16563666.66666668,2021-07-10
501,5404,187,2229754,31166.666666666664,16594833.333333345,2021-07-11
502,6662,238,2236416,39666.666666666664,16634500.000000011,2021-07-12
503,5561,195,2241977,32500.0,16667000.000000011,2021-07-13
504,6160,269,2248137,44833.333333333336,16711833.333333345,2021-07-14
505,6313,178,2254450,29666.666666666664,16741500.000000011,2021-07-15
506,4972,168,2259422,28000.0,16769500.000000011,2021-07-16
507,4880,141,2264302,23500.0,16793000.00000001,2021-07-17
508,4483,163,2268785,27166.666666666668,16820166.66666668,2021-07-18
509,5081,185,2273866,30833.333333333332,16851000.00000001,2021-07-19
510,4215,156,2278081,26000.0,16877000.00000001,2021-07-20
511,3593,145,2281674,24166.666666666668,16901166.66666668,2021-07-21
512,4965,187,2286639,31166.666666666664,16932333.333333347,2021-07-22
513,3714,116,2290353,19333.333333333332,16951666.66666668,2021-07-23
514,4261,151,2294614,25166.666666666668,16976833.333333347,2021-07-24
515,5098,220,2299712,36666.666666666664,17013500.000000015,2021-07-25
516,4715,150,2304427,25000.0,17038500.000000015,2021-07-26
517,4003,115,2308430,19166.666666666668,17057666.666666683,2021-07-27
518,3671,146,2312101,24333.333333333332,17082000.000000015,2021-07-28
519,5111,169,2317212,28166.666666666668,17110166.666666683,2021-07-29
520,3882,131,2321094,21833.333333333332,17132000.000000015,2021-07-30
521,3758,124,2324852,20666.666666666668,17152666.666666683,2021-07-31
522,3870,134,2328722,22333.333333333332,17175000.000000015,2021-08-01
523,4258,115,2332980,19166.666666666668,17194166.666666683,2021-08-02
524,4592,185,2337572,30833.333333333332,17225000.000000015,2021-08-03
525,3509,118,2341081,19666.666666666668,17244666.666666683,2021-08-04
526,4708,123,2345789,20500.0,17265166.666666683,2021-08-05
527,3970,111,2349759,18500.0,17283666.666666683,2021-08-06
528,3521,133,2353280,22166.666666666668,17305833.33333335,2021-08-07
529,3732,133,2357012,22166.666666666668,17328000.00000002,2021-08-08
530,3668,132,2360680,22000.0,17350000.00000002,2021-08-09
531,3288,118,2363968,19666.666666666668,17369666.666666687,2021-08-10
532,3109,108,2367077,18000.0,17387666.666666687,2021-08-11
533,3980,117,2371057,19500.0,17407166.666666687,2021-08-12
534,3736,138,2374793,23000.0,17430166.666666687,2021-08-13
535,3027,127,2377820,21166.666666666668,17451333.333333354,2021-08-14
536,3102,98,2380922,16333.333333333332,17467666.666666687,2021-08-15
537,3436,140,2384358,23333.333333333332,17491000.00000002,2021-08-16
538,2768,92,2387126,15333.333333333332,17506333.33333335,2021-08-17
539,3037,108,2390163,18000.0,17524333.33333335,2021-08-18
540,3406,98,2393569,16333.333333333332,17540666.666666683,2021-08-19
541,2955,112,2396524,18666.666666666668,17559333.33333335,2021-08-20
542,2771,98,2399295,16333.333333333332,17575666.666666683,2021-08-21
543,2451,83,2401746,13833.333333333334,17589500.000000015,2021-08-22
544,2938,105,2404684,17500.0,17607000.000000015,2021-08-23
545,2443,86,2407127,14333.333333333334,17621333.333333347,2021-08-24
546,3197,127,2410324,21166.666666666668,17642500.000000015,2021-08-25
547,3489,122,2413813,20333.333333333332,17662833.333333347,2021-08-26
548,2829,99,2416642,16500.0,17679333.333333347,2021-08-27
549,2631,79,2419273,13166.666666666666,17692500.000000015,2021-08-28
550,2610,99,2421883,16500.0,17709000.000000015,2021-08-29
551,2670,97,2424553,16166.666666666666,17725166.666666683,2021-08-30
552,2153,72,2426706,12000.0,17737166.666666683,2021-08-31
553,2308,74,2429014,12333.333333333334,17749500.000000015,2021-09-01
554,3208,95,2432222,15833.333333333332,17765333.333333347,2021-09-02
555,2902,120,2435124,20000.0,17785333.333333347,2021-09-03
556,2336,61,2437460,10166.666666666666,17795500.000000015,2021-09-04
557,2578,90,2440038,15000.0,17810500.000000015,2021-09-05
558,5065,181,2445103,30166.666666666664,17840666.666666683,2021-09-06
