,cases,deaths,cases_cum,case_adj,case_adj_cum,date
0,1,0,1,0.0,0.0,2020-02-26
1,3,0,4,0.0,0.0,2020-02-27
2,3,1,7,166.66666666666666,166.66666666666666,2020-02-28
3,2,0,9,0.0,166.66666666666666,2020-02-29
4,11,1,20,166.66666666666666,333.3333333333333,2020-03-01
5,34,0,54,0.0,333.3333333333333,2020-03-02
6,27,0,81,0.0,333.3333333333333,2020-03-03
7,25,0,106,0.0,333.3333333333333,2020-03-04
8,42,2,148,333.3333333333333,666.6666666666666,2020-03-05
9,32,1,180,166.66666666666666,833.3333333333333,2020-03-06
10,45,1,225,166.66666666666666,999.9999999999999,2020-03-07
11,35,2,260,333.3333333333333,1333.3333333333333,2020-03-08
12,42,2,302,333.3333333333333,1666.6666666666665,2020-03-09
13,111,5,413,833.3333333333334,2500.0,2020-03-10
14,85,8,498,1333.3333333333333,3833.333333333333,2020-03-11
15,105,12,603,2000.0,5833.333333333333,2020-03-12
16,131,6,734,1000.0,6833.333333333333,2020-03-13
17,122,11,856,1833.3333333333333,8666.666666666666,2020-03-14
18,259,12,1115,2000.0,10666.666666666666,2020-03-15
19,252,12,1367,2000.0,12666.666666666666,2020-03-16
20,233,16,1600,2666.6666666666665,15333.333333333332,2020-03-17
21,222,22,1822,3666.6666666666665,19000.0,2020-03-18
22,214,9,2036,1500.0,20500.0,2020-03-19
23,378,17,2414,2833.3333333333335,23333.333333333332,2020-03-20
24,194,18,2608,3000.0,26333.333333333332,2020-03-21
25,205,22,2813,3666.6666666666665,30000.0,2020-03-22
26,301,17,3114,2833.3333333333335,32833.333333333336,2020-03-23
27,262,17,3376,2833.3333333333335,35666.66666666667,2020-03-24
28,293,25,3669,4166.666666666667,39833.333333333336,2020-03-25
29,276,29,3945,4833.333333333333,44666.66666666667,2020-03-26
30,276,30,4221,5000.0,49666.66666666667,2020-03-27
31,225,19,4446,3166.6666666666665,52833.333333333336,2020-03-28
32,223,23,4669,3833.333333333333,56666.66666666667,2020-03-29
33,300,24,4969,4000.0,60666.66666666667,2020-03-30
34,2338,21,7307,3500.0,64166.66666666667,2020-03-31
35,456,32,7763,5333.333333333333,69500.0,2020-04-01
36,2983,34,10746,5666.666666666667,75166.66666666667,2020-04-02
37,280,29,11026,4833.333333333333,80000.0,2020-04-03
38,256,21,11282,3500.0,83500.0,2020-04-04
39,254,23,11536,3833.333333333333,87333.33333333333,2020-04-05
40,241,19,11777,3166.6666666666665,90500.0,2020-04-06
41,256,12,12033,2000.0,92500.0,2020-04-07
42,292,27,12325,4500.0,97000.0,2020-04-08
43,269,24,12594,4000.0,101000.0,2020-04-09
44,414,32,13008,5333.333333333333,106333.33333333333,2020-04-10
45,276,26,13284,4333.333333333333,110666.66666666666,2020-04-11
46,305,22,13589,3666.6666666666665,114333.33333333333,2020-04-12
47,373,25,13962,4166.666666666667,118500.0,2020-04-13
48,346,38,14308,6333.333333333333,124833.33333333333,2020-04-14
49,442,27,14750,4500.0,129333.33333333333,2020-04-15
50,335,28,15085,4666.666666666667,134000.0,2020-04-16
51,410,39,15495,6500.0,140500.0,2020-04-17
52,443,50,15938,8333.333333333334,148833.33333333334,2020-04-18
53,393,34,16331,5666.666666666667,154500.0,2020-04-19
54,753,71,17084,11833.333333333334,166333.33333333334,2020-04-20
55,461,48,17545,8000.0,174333.33333333334,2020-04-21
56,538,44,18083,7333.333333333333,181666.6666666667,2020-04-22
57,543,40,18626,6666.666666666667,188333.33333333334,2020-04-23
58,577,46,19203,7666.666666666666,196000.0,2020-04-24
59,568,62,19771,10333.333333333334,206333.33333333334,2020-04-25
60,581,48,20352,8000.0,214333.33333333334,2020-04-26
61,650,46,21002,7666.666666666666,222000.0,2020-04-27
62,639,46,21641,7666.666666666666,229666.66666666666,2020-04-28
63,594,45,22235,7500.0,237166.66666666666,2020-04-29
64,907,70,23142,11666.666666666666,248833.3333333333,2020-04-30
65,6304,65,29446,10833.333333333334,259666.66666666666,2020-05-01
66,675,52,30121,8666.666666666666,268333.3333333333,2020-05-02
67,671,64,30792,10666.666666666666,279000.0,2020-05-03
68,3467,59,34259,9833.333333333334,288833.3333333333,2020-05-04
69,863,71,35122,11833.333333333334,300666.6666666666,2020-05-05
70,758,50,35880,8333.333333333334,308999.99999999994,2020-05-06
71,823,53,36703,8833.333333333334,317833.33333333326,2020-05-07
72,900,63,37603,10500.0,328333.33333333326,2020-05-08
73,780,54,38383,9000.0,337333.33333333326,2020-05-09
74,1082,72,39465,12000.0,349333.33333333326,2020-05-10
75,1248,59,40713,9833.333333333334,359166.66666666657,2020-05-11
76,1141,59,41854,9833.333333333334,368999.9999999999,2020-05-12
77,1035,59,42889,9833.333333333334,378833.3333333332,2020-05-13
78,1051,63,43940,10500.0,389333.3333333332,2020-05-14
79,1549,85,45489,14166.666666666666,403499.9999999999,2020-05-15
80,954,62,46443,10333.333333333334,413833.3333333332,2020-05-16
81,1086,59,47529,9833.333333333334,423666.6666666665,2020-05-17
82,1584,85,49113,14166.666666666666,437833.3333333332,2020-05-18
83,1341,86,50454,14333.333333333334,452166.6666666665,2020-05-19
84,1732,105,52186,17500.0,469666.6666666665,2020-05-20
85,1516,85,53702,14166.666666666666,483833.3333333332,2020-05-21
86,1451,87,55153,14500.0,498333.3333333332,2020-05-22
87,1237,77,56390,12833.333333333334,511166.6666666665,2020-05-23
88,1111,81,57501,13500.0,524666.6666666665,2020-05-24
89,1907,114,59408,19000.0,543666.6666666665,2020-05-25
90,1626,77,61034,12833.333333333334,556499.9999999999,2020-05-26
91,1609,81,62643,13500.0,569999.9999999999,2020-05-27
92,1714,88,64357,14666.666666666666,584666.6666666665,2020-05-28
93,1703,93,66060,15500.0,600166.6666666665,2020-05-29
94,1654,115,67714,19166.666666666668,619333.3333333331,2020-05-30
95,1489,109,69203,18166.666666666668,637499.9999999998,2020-05-31
96,3155,155,72358,25833.333333333332,663333.3333333331,2020-06-01
97,2072,117,74430,19500.0,682833.3333333331,2020-06-02
98,2203,121,76633,20166.666666666668,702999.9999999998,2020-06-03
99,2194,128,78827,21333.333333333332,724333.3333333331,2020-06-04
100,2568,134,81395,22333.333333333332,746666.6666666665,2020-06-05
101,2291,136,83686,22666.666666666668,769333.3333333331,2020-06-06
102,2133,132,85819,22000.0,791333.3333333331,2020-06-07
103,2961,141,88780,23500.0,814833.3333333331,2020-06-08
104,2627,128,91407,21333.333333333332,836166.6666666665,2020-06-09
105,3708,198,95115,33000.0,869166.6666666665,2020-06-10
106,3258,112,98373,18666.666666666668,887833.3333333331,2020-06-11
107,3193,149,101566,24833.333333333332,912666.6666666665,2020-06-12
108,2624,128,104190,21333.333333333332,933999.9999999999,2020-06-13
109,2714,143,106904,23833.333333333332,957833.3333333333,2020-06-14
110,4401,186,111305,31000.0,988833.3333333333,2020-06-15
111,3658,160,114963,26666.666666666668,1015499.9999999999,2020-06-16
112,3274,148,118237,24666.666666666668,1040166.6666666665,2020-06-17
113,3747,183,121984,30500.0,1070666.6666666665,2020-06-18
114,3749,168,125733,28000.0,1098666.6666666665,2020-06-19
115,4096,192,129829,32000.0,1130666.6666666665,2020-06-20
116,2928,151,132757,25166.666666666668,1155833.3333333333,2020-06-21
117,4147,188,136904,31333.333333333332,1187166.6666666665,2020-06-22
118,3557,159,140461,26500.0,1213666.6666666665,2020-06-23
119,3882,158,144343,26333.333333333332,1239999.9999999998,2020-06-24
120,5010,188,149353,31333.333333333332,1271333.333333333,2020-06-25
121,4261,172,153614,28666.666666666668,1299999.9999999998,2020-06-26
122,3217,156,156831,26000.0,1325999.9999999998,2020-06-27
123,3502,166,160333,27666.666666666668,1353666.6666666665,2020-06-28
124,4199,170,164532,28333.333333333332,1381999.9999999998,2020-06-29
125,4349,218,168881,36333.333333333336,1418333.333333333,2020-06-30
126,5967,308,174848,51333.333333333336,1469666.6666666663,2020-07-01
127,4609,209,179457,34833.333333333336,1504499.9999999995,2020-07-02
128,5065,213,184522,35500.0,1539999.9999999995,2020-07-03
129,4250,209,188772,34833.333333333336,1574833.3333333328,2020-07-04
130,4447,201,193219,33500.0,1608333.3333333328,2020-07-05
131,5785,241,199004,40166.666666666664,1648499.9999999995,2020-07-06
132,5043,208,204047,34666.666666666664,1683166.6666666663,2020-07-07
133,5015,211,209062,35166.666666666664,1718333.333333333,2020-07-08
134,4851,222,213913,37000.0,1755333.333333333,2020-07-09
135,6720,288,220633,48000.0,1803333.333333333,2020-07-10
136,4330,204,224963,34000.0,1837333.333333333,2020-07-11
137,4365,183,229328,30500.0,1867833.333333333,2020-07-12
138,6285,198,235613,33000.0,1900833.333333333,2020-07-13
139,5147,208,240760,34666.666666666664,1935499.9999999998,2020-07-14
140,5779,226,246539,37666.666666666664,1973166.6666666665,2020-07-15
141,5056,219,251595,36500.0,2009666.6666666665,2020-07-16
142,5898,199,257493,33166.666666666664,2042833.3333333333,2020-07-17
143,4796,169,262289,28166.666666666668,2071000.0,2020-07-18
144,4445,184,266734,30666.666666666664,2101666.6666666665,2020-07-19
145,7257,291,273991,48500.0,2150166.6666666665,2020-07-20
146,4692,182,278683,30333.333333333332,2180500.0,2020-07-21
147,4841,192,283524,32000.0,2212500.0,2020-07-22
148,5030,192,288554,32000.0,2244500.0,2020-07-23
149,5222,197,293776,32833.333333333336,2277333.3333333335,2020-07-24
150,4538,180,298314,30000.0,2307333.3333333335,2020-07-25
151,3738,165,302052,27500.0,2334833.3333333335,2020-07-26
152,5351,193,307403,32166.666666666664,2367000.0,2020-07-27
153,4486,177,311889,29500.0,2396500.0,2020-07-28
154,4088,147,315977,24500.0,2421000.0,2020-07-29
155,4264,150,320241,25000.0,2446000.0,2020-07-30
156,4749,175,324990,29166.666666666664,2475166.6666666665,2020-07-31
157,5064,219,330054,36500.0,2511666.6666666665,2020-08-01
158,3580,157,333634,26166.666666666668,2537833.333333333,2020-08-02
159,4970,152,338604,25333.333333333332,2563166.6666666665,2020-08-03
160,4100,145,342704,24166.666666666668,2587333.333333333,2020-08-04
161,4167,135,346871,22500.0,2609833.333333333,2020-08-05
162,3955,151,350826,25166.666666666668,2634999.9999999995,2020-08-06
163,4493,175,355319,29166.666666666664,2664166.666666666,2020-08-07
164,3656,153,358975,25500.0,2689666.666666666,2020-08-08
165,3493,148,362468,24666.666666666668,2714333.3333333326,2020-08-09
166,5584,215,368052,35833.333333333336,2750166.666666666,2020-08-10
167,3826,120,371878,20000.0,2770166.666666666,2020-08-11
168,3980,123,375858,20500.0,2790666.666666666,2020-08-12
169,3734,136,379592,22666.666666666668,2813333.3333333326,2020-08-13
170,4140,138,383732,23000.0,2836333.3333333326,2020-08-14
171,3554,151,387286,25166.666666666668,2861499.999999999,2020-08-15
172,2781,126,390067,21000.0,2882499.999999999,2020-08-16
173,3943,114,394010,19000.0,2901499.999999999,2020-08-17
174,3449,119,397459,19833.333333333332,2921333.3333333326,2020-08-18
175,3333,124,400792,20666.666666666668,2941999.999999999,2020-08-19
176,4059,174,404851,29000.0,2970999.999999999,2020-08-20
177,3567,134,408418,22333.333333333332,2993333.3333333326,2020-08-21
178,2833,99,411251,16500.0,3009833.3333333326,2020-08-22
179,2832,122,414083,20333.333333333332,3030166.666666666,2020-08-23
180,3984,107,418067,17833.333333333332,3047999.9999999995,2020-08-24
181,3629,115,421696,19166.666666666668,3067166.666666666,2020-08-25
182,3063,132,424759,22000.0,3089166.666666666,2020-08-26
183,3337,120,428096,20000.0,3109166.666666666,2020-08-27
184,3763,120,431859,20000.0,3129166.666666666,2020-08-28
185,5878,89,437737,14833.333333333332,3143999.9999999995,2020-08-29
186,2565,113,440302,18833.333333333332,3162833.333333333,2020-08-30
187,3853,144,444155,24000.0,3186833.333333333,2020-08-31
188,4240,173,448395,28833.333333333332,3215666.6666666665,2020-09-01
189,3287,88,451682,14666.666666666666,3230333.333333333,2020-09-02
190,3470,120,455152,20000.0,3250333.333333333,2020-09-03
191,3435,114,458587,19000.0,3269333.333333333,2020-09-04
192,2610,89,461197,14833.333333333332,3284166.6666666665,2020-09-05
193,2228,87,463425,14500.0,3298666.6666666665,2020-09-06
194,2612,110,466037,18333.333333333332,3317000.0,2020-09-07
195,3635,106,469672,17666.666666666668,3334666.6666666665,2020-09-08
196,3327,113,472999,18833.333333333332,3353500.0,2020-09-09
197,4177,133,477176,22166.666666666668,3375666.6666666665,2020-09-10
198,3249,89,480425,14833.333333333332,3390500.0,2020-09-11
199,2383,99,482808,16500.0,3407000.0,2020-09-12
200,2178,75,484986,12500.0,3419500.0,2020-09-13
201,3548,121,488534,20166.666666666668,3439666.6666666665,2020-09-14
202,3068,102,491602,17000.0,3456666.6666666665,2020-09-15
203,2726,92,494328,15333.333333333332,3472000.0,2020-09-16
204,3005,115,497333,19166.666666666668,3491166.6666666665,2020-09-17
205,2997,79,500330,13166.666666666666,3504333.333333333,2020-09-18
206,2402,87,502732,14500.0,3518833.333333333,2020-09-19
207,2607,99,505339,16500.0,3535333.333333333,2020-09-20
208,3335,101,508674,16833.333333333332,3552166.6666666665,2020-09-21
209,2813,75,511487,12500.0,3564666.6666666665,2020-09-22
210,2789,90,514276,15000.0,3579666.6666666665,2020-09-23
211,2731,106,517007,17666.666666666668,3597333.333333333,2020-09-24
212,3012,78,520019,13000.0,3610333.333333333,2020-09-25
213,3330,75,523349,12500.0,3622833.333333333,2020-09-26
214,2040,84,525389,14000.0,3636833.333333333,2020-09-27
215,2923,77,528312,12833.333333333334,3649666.6666666665,2020-09-28
216,2449,74,530761,12333.333333333334,3662000.0,2020-09-29
217,2447,73,533208,12166.666666666666,3674166.6666666665,2020-09-30
218,3054,112,536262,18666.666666666668,3692833.333333333,2020-10-01
219,2475,100,538737,16666.666666666668,3709499.9999999995,2020-10-02
220,1957,66,540694,11000.0,3720499.9999999995,2020-10-03
221,1789,74,542483,12333.333333333334,3732833.333333333,2020-10-04
222,2693,79,545176,13166.666666666666,3745999.9999999995,2020-10-05
223,2203,67,547379,11166.666666666666,3757166.666666666,2020-10-06
224,2117,75,549496,12500.0,3769666.666666666,2020-10-07
225,2266,73,551762,12166.666666666666,3781833.3333333326,2020-10-08
226,2516,91,554278,15166.666666666666,3796999.999999999,2020-10-09
227,2440,105,556718,17500.0,3814499.999999999,2020-10-10
228,1744,57,558462,9500.0,3823999.999999999,2020-10-11
229,2145,70,560607,11666.666666666666,3835666.6666666656,2020-10-12
230,2547,63,563154,10500.0,3846166.6666666656,2020-10-13
231,2374,68,565528,11333.333333333334,3857499.999999999,2020-10-14
232,2692,71,568220,11833.333333333334,3869333.3333333326,2020-10-15
233,2743,85,570963,14166.666666666666,3883499.999999999,2020-10-16
234,2682,58,573645,9666.666666666666,3893166.6666666656,2020-10-17
235,2152,69,575797,11500.0,3904666.6666666656,2020-10-18
236,3069,64,578866,10666.666666666666,3915333.333333332,2020-10-19
237,2945,88,581811,14666.666666666666,3929999.9999999986,2020-10-20
238,2450,80,584261,13333.333333333334,3943333.333333332,2020-10-21
239,2617,75,586878,12500.0,3955833.333333332,2020-10-22
240,2835,68,589713,11333.333333333334,3967166.6666666656,2020-10-23
241,2348,76,592061,12666.666666666666,3979833.333333332,2020-10-24
242,2390,98,594451,16333.333333333332,3996166.6666666656,2020-10-25
243,3188,84,597639,14000.0,4010166.6666666656,2020-10-26
244,2639,73,600278,12166.666666666666,4022333.333333332,2020-10-27
245,2663,87,602941,14500.0,4036833.333333332,2020-10-28
246,2440,81,605381,13500.0,4050333.333333332,2020-10-29
247,2899,95,608280,15833.333333333332,4066166.6666666656,2020-10-30
248,2488,73,610768,12166.666666666666,4078333.333333332,2020-10-31
249,3525,117,614293,19500.0,4097833.333333332,2020-11-01
250,3387,101,617680,16833.333333333332,4114666.6666666656,2020-11-02
251,4043,95,621723,15833.333333333332,4130499.999999999,2020-11-03
252,3611,86,625334,14333.333333333334,4144833.3333333326,2020-11-04
253,4089,106,629423,17666.666666666668,4162499.999999999,2020-11-05
254,4415,134,633838,22333.333333333332,4184833.3333333326,2020-11-06
255,3960,134,637798,22333.333333333332,4207166.666666666,2020-11-07
256,4154,116,641952,19333.333333333332,4226499.999999999,2020-11-08
257,5624,127,647576,21166.666666666668,4247666.666666666,2020-11-09
258,5522,165,653098,27500.0,4275166.666666666,2020-11-10
259,4954,142,658052,23666.666666666668,4298833.333333333,2020-11-11
260,5065,135,663117,22500.0,4321333.333333333,2020-11-12
261,5706,144,668823,24000.0,4345333.333333333,2020-11-13
262,4985,137,673808,22833.333333333332,4368166.666666666,2020-11-14
263,5453,156,679261,26000.0,4394166.666666666,2020-11-15
264,6391,138,685652,23000.0,4417166.666666666,2020-11-16
265,5545,144,691197,24000.0,4441166.666666666,2020-11-17
266,5699,159,696896,26500.0,4467666.666666666,2020-11-18
267,5855,170,702751,28333.333333333332,4495999.999999999,2020-11-19
268,7530,221,710281,36833.333333333336,4532833.333333332,2020-11-20
269,5499,122,715780,20333.333333333332,4553166.666666665,2020-11-21
270,5692,145,721472,24166.666666666668,4577333.333333332,2020-11-22
271,7447,199,728919,33166.666666666664,4610499.999999999,2020-11-23
272,6034,145,734953,24166.666666666668,4634666.666666666,2020-11-24
273,6424,183,741377,30500.0,4665166.666666666,2020-11-25
274,6291,162,747668,27000.0,4692166.666666666,2020-11-26
275,7103,177,754771,29500.0,4721666.666666666,2020-11-27
276,6100,168,760871,28000.0,4749666.666666666,2020-11-28
277,5656,151,766527,25166.666666666668,4774833.333333333,2020-11-29
278,8423,213,774950,35500.0,4810333.333333333,2020-11-30
279,8029,272,782979,45333.333333333336,4855666.666666666,2020-12-01
280,6172,171,789151,28500.0,4884166.666666666,2020-12-02
281,6189,149,795340,24833.333333333332,4908999.999999999,2020-12-03
282,7082,188,802422,31333.333333333332,4940333.333333332,2020-12-04
283,6355,170,808777,28333.333333333332,4968666.666666665,2020-12-05
284,5557,150,814334,25000.0,4993666.666666665,2020-12-06
285,7143,185,821477,30833.333333333332,5024499.999999998,2020-12-07
286,5973,182,827450,30333.333333333332,5054833.333333331,2020-12-08
287,6024,143,833474,23833.333333333332,5078666.666666664,2020-12-09
288,6539,209,840013,34833.333333333336,5113499.999999997,2020-12-10
289,6259,165,846272,27500.0,5140999.999999997,2020-12-11
290,5505,148,851777,24666.666666666668,5165666.666666664,2020-12-12
291,5132,177,856909,29500.0,5195166.666666664,2020-12-13
292,6874,181,863783,30166.666666666664,5225333.333333331,2020-12-14
293,6055,162,869838,27000.0,5252333.333333331,2020-12-15
294,5220,128,875058,21333.333333333332,5273666.666666664,2020-12-16
295,5443,157,880501,26166.666666666668,5299833.333333331,2020-12-17
296,5777,182,886278,30333.333333333332,5330166.666666664,2020-12-18
297,4710,137,890988,22833.333333333332,5352999.999999997,2020-12-19
298,5072,202,896060,33666.666666666664,5386666.666666664,2020-12-20
299,5318,159,901378,26500.0,5413166.666666664,2020-12-21
300,4949,135,906327,22500.0,5435666.666666664,2020-12-22
301,5622,149,911949,24833.333333333332,5460499.999999997,2020-12-23
302,5363,158,917312,26333.333333333332,5486833.33333333,2020-12-24
303,5639,200,922951,33333.333333333336,5520166.666666663,2020-12-25
304,5777,174,928728,29000.0,5549166.666666663,2020-12-26
305,5391,173,934119,28833.333333333332,5577999.999999996,2020-12-27
306,6735,181,940854,30166.666666666664,5608166.666666663,2020-12-28
307,5144,153,945998,25500.0,5633666.666666663,2020-12-29
308,5973,184,951971,30666.666666666664,5664333.33333333,2020-12-30
309,6086,181,958057,30166.666666666664,5694499.999999997,2020-12-31
310,8681,247,966738,41166.666666666664,5735666.666666664,2021-01-01
311,7921,208,974659,34666.666666666664,5770333.333333331,2021-01-02
312,7917,209,982576,34833.333333333336,5805166.666666664,2021-01-03
313,9344,214,991920,35666.666666666664,5840833.333333331,2021-01-04
314,7251,197,999171,32833.333333333336,5873666.666666664,2021-01-05
315,6520,195,1005691,32500.0,5906166.666666664,2021-01-06
316,6459,148,1012150,24666.666666666668,5930833.333333331,2021-01-07
317,7027,208,1019177,34666.666666666664,5965499.999999998,2021-01-08
318,6189,177,1025366,29500.0,5994999.999999998,2021-01-09
319,6474,233,1031840,38833.333333333336,6033833.333333331,2021-01-10
320,6965,184,1038805,30666.666666666664,6064499.999999998,2021-01-11
321,5859,153,1044664,25500.0,6089999.999999998,2021-01-12
322,5675,176,1050339,29333.333333333332,6119333.333333331,2021-01-13
323,5780,156,1056119,26000.0,6145333.333333331,2021-01-14
324,6787,185,1062906,30833.333333333332,6176166.666666664,2021-01-15
325,5494,170,1068400,28333.333333333332,6204499.999999997,2021-01-16
326,5257,154,1073657,25666.666666666668,6230166.666666664,2021-01-17
327,6788,187,1080445,31166.666666666664,6261333.333333331,2021-01-18
328,5809,163,1086254,27166.666666666668,6288499.999999998,2021-01-19
329,6279,210,1092533,35000.0,6323499.999999998,2021-01-20
330,5373,165,1097906,27500.0,6350999.999999998,2021-01-21
331,5485,148,1103391,24666.666666666668,6375666.666666665,2021-01-22
332,5157,164,1108548,27333.333333333332,6402999.999999998,2021-01-23
333,5077,139,1113625,23166.666666666668,6426166.666666665,2021-01-24
334,6478,202,1120103,33666.666666666664,6459833.333333332,2021-01-25
335,5020,137,1125123,22833.333333333332,6482666.666666665,2021-01-26
336,4799,154,1129922,25666.666666666668,6508333.333333332,2021-01-27
337,4870,161,1134792,26833.333333333332,6535166.666666665,2021-01-28
338,4655,155,1139447,25833.333333333332,6560999.999999998,2021-01-29
339,4177,156,1143624,26000.0,6586999.999999998,2021-01-30
340,4200,154,1147824,25666.666666666668,6612666.666666665,2021-01-31
341,6694,275,1154518,45833.333333333336,6658499.999999998,2021-02-01
342,4832,223,1159350,37166.666666666664,6695666.666666665,2021-02-02
343,4636,193,1163986,32166.666666666664,6727833.333333332,2021-02-03
344,4703,167,1168689,27833.333333333332,6755666.666666665,2021-02-04
345,5556,218,1174245,36333.333333333336,6791999.999999998,2021-02-05
346,4925,207,1179170,34500.0,6826499.999999998,2021-02-06
347,4651,206,1183821,34333.333333333336,6860833.333333331,2021-02-07
348,6083,251,1189904,41833.333333333336,6902666.666666664,2021-02-08
349,5068,228,1194972,38000.0,6940666.666666664,2021-02-09
350,5663,305,1200635,50833.333333333336,6991499.999999997,2021-02-10
351,5120,271,1205755,45166.666666666664,7036666.666666664,2021-02-11
352,6373,321,1212128,53500.0,7090166.666666664,2021-02-12
353,5702,296,1217830,49333.333333333336,7139499.999999997,2021-02-13
354,6178,321,1224008,53500.0,7192999.999999997,2021-02-14
355,8416,445,1232424,74166.66666666667,7267166.666666664,2021-02-15
356,6920,331,1239344,55166.666666666664,7322333.333333331,2021-02-16
357,7437,381,1246781,63500.0,7385833.333333331,2021-02-17
358,8026,430,1254807,71666.66666666667,7457499.999999998,2021-02-18
359,8421,408,1263228,68000.0,7525499.999999998,2021-02-19
360,9099,564,1272327,94000.0,7619499.999999998,2021-02-20
361,7548,409,1279875,68166.66666666667,7687666.666666665,2021-02-21
362,10128,566,1290003,94333.33333333333,7781999.999999998,2021-02-22
363,8602,464,1298605,77333.33333333333,7859333.333333331,2021-02-23
364,8338,452,1306943,75333.33333333333,7934666.666666664,2021-02-24
365,9035,549,1315978,91500.0,8026166.666666664,2021-02-25
366,10321,519,1326299,86500.0,8112666.666666664,2021-02-26
367,8697,471,1334996,78500.0,8191166.666666664,2021-02-27
368,10023,660,1345019,110000.0,8301166.666666664,2021-02-28
369,14129,1021,1359148,170166.66666666666,8471333.33333333,2021-03-01
370,10095,593,1369243,98833.33333333333,8570166.666666664,2021-03-02
371,9554,670,1378797,111666.66666666667,8681833.33333333,2021-03-03
372,9964,644,1388761,107333.33333333333,8789166.666666664,2021-03-04
373,11623,773,1400384,128833.33333333333,8917999.999999998,2021-03-05
374,9907,584,1410291,97333.33333333333,9015333.333333332,2021-03-06
375,9832,625,1420123,104166.66666666667,9119499.999999998,2021-03-07
376,12690,797,1432813,132833.33333333334,9252333.333333332,2021-03-08
377,10386,696,1443199,116000.0,9368333.333333332,2021-03-09
378,11410,846,1454609,141000.0,9509333.333333332,2021-03-10
379,9825,654,1464434,109000.0,9618333.333333332,2021-03-11
380,11233,665,1475667,110833.33333333333,9729166.666666666,2021-03-12
381,9611,625,1485278,104166.66666666667,9833333.333333332,2021-03-13
382,9263,631,1494541,105166.66666666667,9938499.999999998,2021-03-14
383,12170,802,1506711,133666.66666666666,10072166.666666664,2021-03-15
384,9284,622,1515995,103666.66666666667,10175833.33333333,2021-03-16
385,8920,576,1524915,96000.0,10271833.33333333,2021-03-17
386,9043,629,1533958,104833.33333333333,10376666.666666664,2021-03-18
387,9802,635,1543760,105833.33333333333,10482499.999999998,2021-03-19
388,9721,729,1553481,121500.0,10603999.999999998,2021-03-20
389,7363,517,1560844,86166.66666666667,10690166.666666664,2021-03-21
390,9715,516,1570559,86000.0,10776166.666666664,2021-03-22
391,8013,529,1578572,88166.66666666667,10864333.33333333,2021-03-23
392,7213,472,1585785,78666.66666666667,10942999.999999996,2021-03-24
393,7743,494,1593528,82333.33333333333,11025333.33333333,2021-03-25
394,7833,448,1601361,74666.66666666667,11099999.999999996,2021-03-26
395,6342,396,1607703,66000.0,11165999.999999996,2021-03-27
396,5812,398,1613515,66333.33333333333,11232333.33333333,2021-03-28
397,6734,376,1620249,62666.666666666664,11294999.999999996,2021-03-29
398,5392,401,1625641,66833.33333333333,11361833.33333333,2021-03-30
399,5583,366,1631224,61000.0,11422833.33333333,2021-03-31
400,7808,535,1639032,89166.66666666667,11511999.999999996,2021-04-01
401,5963,378,1644995,63000.0,11574999.999999996,2021-04-02
402,5730,314,1650725,52333.333333333336,11627333.33333333,2021-04-03
403,5771,350,1656496,58333.33333333333,11685666.666666664,2021-04-04
404,7320,395,1663816,65833.33333333333,11751499.999999998,2021-04-05
405,5730,324,1669546,54000.0,11805499.999999998,2021-04-06
406,5196,339,1674742,56500.0,11861999.999999998,2021-04-07
407,5410,340,1680152,56666.666666666664,11918666.666666664,2021-04-08
408,5929,310,1686081,51666.666666666664,11970333.33333333,2021-04-09
409,6099,390,1692180,65000.0,12035333.33333333,2021-04-10
410,4903,277,1697083,46166.666666666664,12081499.999999996,2021-04-11
411,6527,330,1703610,55000.0,12136499.999999996,2021-04-12
412,5022,278,1708632,46333.333333333336,12182833.33333333,2021-04-13
413,5158,303,1713790,50500.0,12233333.33333333,2021-04-14
414,5349,280,1719139,46666.666666666664,12279999.999999996,2021-04-15
415,5493,291,1724632,48500.0,12328499.999999996,2021-04-16
416,4482,226,1729114,37666.666666666664,12366166.666666662,2021-04-17
417,4371,262,1733485,43666.666666666664,12409833.333333328,2021-04-18
418,5865,280,1739350,46666.666666666664,12456499.999999994,2021-04-19
419,5968,341,1745318,56833.333333333336,12513333.333333328,2021-04-20
420,4497,254,1749815,42333.333333333336,12555666.666666662,2021-04-21
421,5006,261,1754821,43500.0,12599166.666666662,2021-04-22
422,5507,271,1760328,45166.666666666664,12644333.333333328,2021-04-23
423,4965,244,1765293,40666.666666666664,12684999.999999994,2021-04-24
424,5216,271,1770509,45166.666666666664,12730166.66666666,2021-04-25
425,6222,275,1776731,45833.333333333336,12775999.999999994,2021-04-26
426,5177,259,1781908,43166.666666666664,12819166.66666666,2021-04-27
427,5015,295,1786923,49166.666666666664,12868333.333333327,2021-04-28
428,4645,206,1791568,34333.333333333336,12902666.66666666,2021-04-29
429,5823,275,1797391,45833.333333333336,12948499.999999994,2021-04-30
430,6544,411,1803935,68500.0,13016999.999999994,2021-05-01
431,5346,274,1809281,45666.666666666664,13062666.66666666,2021-05-02
432,6701,296,1815982,49333.333333333336,13111999.999999994,2021-05-03
433,5769,269,1821751,44833.333333333336,13156833.333333328,2021-05-04
434,5758,301,1827509,50166.666666666664,13206999.999999994,2021-05-05
435,5401,261,1832910,43500.0,13250499.999999994,2021-05-06
436,6185,277,1839095,46166.666666666664,13296666.66666666,2021-05-07
437,5958,284,1845053,47333.333333333336,13343999.999999994,2021-05-08
438,6084,280,1851137,46666.666666666664,13390666.66666666,2021-05-09
439,8544,386,1859681,64333.33333333333,13454999.999999994,2021-05-10
440,6448,322,1866129,53666.666666666664,13508666.66666666,2021-05-11
441,6541,299,1872670,49833.333333333336,13558499.999999994,2021-05-12
442,6511,286,1879181,47666.666666666664,13606166.66666666,2021-05-13
443,7798,329,1886979,54833.333333333336,13660999.999999994,2021-05-14
444,7531,344,1894510,57333.333333333336,13718333.333333328,2021-05-15
445,6538,297,1901048,49500.0,13767833.333333328,2021-05-16
446,8403,355,1909451,59166.666666666664,13826999.999999994,2021-05-17
447,7455,342,1916906,57000.0,13883999.999999994,2021-05-18
448,6781,292,1923687,48666.666666666664,13932666.66666666,2021-05-19
449,7939,432,1931626,72000.0,14004666.66666666,2021-05-20
450,7483,305,1939109,50833.333333333336,14055499.999999994,2021-05-21
451,6913,299,1946022,49833.333333333336,14105333.333333328,2021-05-22
452,7040,321,1953062,53500.0,14158833.333333328,2021-05-23
453,9297,397,1962359,66166.66666666667,14224999.999999994,2021-05-24
454,8826,386,1971185,64333.33333333333,14289333.333333328,2021-05-25
455,7916,342,1979101,57000.0,14346333.333333328,2021-05-26
456,8111,312,1987212,52000.0,14398333.333333328,2021-05-27
457,9312,369,1996524,61500.0,14459833.333333328,2021-05-28
458,7577,290,2004101,48333.333333333336,14508166.666666662,2021-05-29
459,7287,340,2011388,56666.666666666664,14564833.333333328,2021-05-30
460,9074,380,2020462,63333.33333333333,14628166.666666662,2021-05-31
461,9824,472,2030286,78666.66666666667,14706833.333333328,2021-06-01
462,8818,302,2039104,50333.333333333336,14757166.666666662,2021-06-02
463,7681,327,2046785,54500.0,14811666.666666662,2021-06-03
464,8833,359,2055618,59833.33333333333,14871499.999999996,2021-06-04
465,8301,284,2063919,47333.333333333336,14918833.33333333,2021-06-05
466,7860,298,2071779,49666.666666666664,14968499.999999996,2021-06-06
467,9054,275,2080833,45833.333333333336,15014333.33333333,2021-06-07
468,7249,260,2088082,43333.333333333336,15057666.666666664,2021-06-08
469,7014,289,2095096,48166.666666666664,15105833.33333333,2021-06-09
470,7681,315,2102777,52500.0,15158333.33333333,2021-06-10
471,7358,281,2110135,46833.333333333336,15205166.666666664,2021-06-11
472,6697,232,2116832,38666.666666666664,15243833.33333333,2021-06-12
473,6037,220,2122869,36666.666666666664,15280499.999999996,2021-06-13
474,8050,246,2130919,41000.0,15321499.999999996,2021-06-14
475,6794,264,2137713,44000.0,15365499.999999996,2021-06-15
476,6269,221,2143982,36833.333333333336,15402333.33333333,2021-06-16
477,5906,219,2149888,36500.0,15438833.33333333,2021-06-17
478,6980,246,2156868,41000.0,15479833.33333333,2021-06-18
479,6050,201,2162918,33500.0,15513333.33333333,2021-06-19
480,6438,253,2169356,42166.666666666664,15555499.999999996,2021-06-20
481,6764,190,2176120,31666.666666666664,15587166.666666662,2021-06-21
482,5410,185,2181530,30833.333333333332,15617999.999999996,2021-06-22
483,4843,191,2186373,31833.333333333332,15649833.33333333,2021-06-23
484,5017,177,2191390,29500.0,15679333.33333333,2021-06-24
485,5371,182,2196761,30333.333333333332,15709666.666666664,2021-06-25
486,4432,170,2201193,28333.333333333332,15737999.999999998,2021-06-26
487,3865,140,2205058,23333.333333333332,15761333.333333332,2021-06-27
488,4984,170,2210042,28333.333333333332,15789666.666666666,2021-06-28
489,3736,112,2213778,18666.666666666668,15808333.333333332,2021-06-29
490,4153,156,2217931,26000.0,15834333.333333332,2021-06-30
491,5024,238,2222955,39666.666666666664,15873999.999999998,2021-07-01
492,4743,163,2227698,27166.666666666668,15901166.666666664,2021-07-02
493,4109,159,2231807,26500.0,15927666.666666664,2021-07-03
494,3915,159,2235722,26500.0,15954166.666666664,2021-07-04
495,4881,186,2240603,31000.0,15985166.666666664,2021-07-05
496,3994,145,2244597,24166.666666666668,16009333.33333333,2021-07-06
497,3917,141,2248514,23500.0,16032833.33333333,2021-07-07
498,4041,140,2252555,23333.333333333332,16056166.666666664,2021-07-08
499,4325,144,2256880,24000.0,16080166.666666664,2021-07-09
500,4190,151,2261070,25166.666666666668,16105333.33333333,2021-07-10
501,3395,109,2264465,18166.666666666668,16123499.999999996,2021-07-11
502,4562,146,2269027,24333.333333333332,16147833.33333333,2021-07-12
503,3507,105,2272534,17500.0,16165333.33333333,2021-07-13
504,3345,113,2275879,18833.333333333332,16184166.666666664,2021-07-14
505,3398,134,2279277,22333.333333333332,16206499.999999998,2021-07-15
506,3339,126,2282616,21000.0,16227499.999999998,2021-07-16
507,2924,119,2285540,19833.333333333332,16247333.333333332,2021-07-17
508,3025,112,2288565,18666.666666666668,16265999.999999998,2021-07-18
509,3652,122,2292217,20333.333333333332,16286333.333333332,2021-07-19
510,3478,155,2295695,25833.333333333332,16312166.666666666,2021-07-20
511,2913,100,2298608,16666.666666666668,16328833.333333332,2021-07-21
512,2801,121,2301409,20166.666666666668,16348999.999999998,2021-07-22
513,3310,100,2304719,16666.666666666668,16365666.666666664,2021-07-23
514,2769,93,2307488,15500.0,16381166.666666664,2021-07-24
515,2844,124,2310332,20666.666666666668,16401833.33333333,2021-07-25
516,3131,114,2313463,19000.0,16420833.33333333,2021-07-26
517,2742,95,2316205,15833.333333333332,16436666.666666664,2021-07-27
518,2661,122,2318866,20333.333333333332,16456999.999999998,2021-07-28
519,2381,105,2321247,17500.0,16474499.999999998,2021-07-29
520,2817,103,2324064,17166.666666666668,16491666.666666664,2021-07-30
521,2677,107,2326741,17833.333333333332,16509499.999999998,2021-07-31
522,3497,172,2330238,28666.666666666668,16538166.666666664,2021-08-01
523,3526,99,2333764,16500.0,16554666.666666664,2021-08-02
524,2848,97,2336612,16166.666666666666,16570833.33333333,2021-08-03
525,2675,100,2339287,16666.666666666668,16587499.999999996,2021-08-04
526,2938,104,2342225,17333.333333333332,16604833.33333333,2021-08-05
527,2742,93,2344967,15500.0,16620333.33333333,2021-08-06
528,2307,67,2347274,11166.666666666666,16631499.999999996,2021-08-07
529,2512,105,2349786,17500.0,16648999.999999996,2021-08-08
530,2963,98,2352749,16333.333333333332,16665333.33333333,2021-08-09
531,2893,105,2355642,17500.0,16682833.33333333,2021-08-10
532,2145,77,2357787,12833.333333333334,16695666.666666664,2021-08-11
533,2266,91,2360053,15166.666666666666,16710833.33333333,2021-08-12
534,4856,140,2364909,23333.333333333332,16734166.666666664,2021-08-13
