t,deaths,cases,cases_cum,nCFR,case_adj,cases_adj_cum,date
53,0,2,2,0.0,0.0,0.0,2020-02-22
54,0,4,6,0.0,0.0,0.0,2020-02-23
55,0,4,10,0.0,0.0,0.0,2020-02-24
56,0,4,14,0.0,0.0,0.0,2020-02-25
57,0,9,23,0.0,0.0,0.0,2020-02-26
58,0,3,26,0.0,0.0,0.0,2020-02-27
59,0,8,34,0.0,0.0,0.0,2020-02-28
61,6,26,60,0.23076923076923078,1000.0,1000.0,2020-03-01
62,7,16,76,0.4375,1166.6666666666667,2166.666666666667,2020-03-02
63,5,18,94,0.2777777777777778,833.3333333333334,3000.0000000000005,2020-03-03
64,2,22,116,0.09090909090909091,333.3333333333333,3333.333333333334,2020-03-04
65,10,21,137,0.47619047619047616,1666.6666666666667,5000.000000000001,2020-03-05
66,9,34,171,0.2647058823529412,1500.0,6500.000000000001,2020-03-06
67,6,23,194,0.2608695652173913,1000.0,7500.000000000001,2020-03-07
68,10,39,233,0.2564102564102564,1666.6666666666667,9166.666666666668,2020-03-08
69,8,66,299,0.12121212121212122,1333.3333333333333,10500.000000000002,2020-03-09
70,21,83,382,0.25301204819277107,3500.0,14000.000000000002,2020-03-10
71,27,83,465,0.3253012048192771,4500.0,18500.0,2020-03-11
72,31,112,577,0.2767857142857143,5166.666666666667,23666.666666666668,2020-03-12
73,35,121,698,0.2892561983471074,5833.333333333333,29500.0,2020-03-13
74,39,171,869,0.22807017543859648,6500.0,36000.0,2020-03-14
75,47,209,1078,0.22488038277511962,7833.333333333333,43833.333333333336,2020-03-15
76,61,236,1314,0.2584745762711864,10166.666666666666,54000.0,2020-03-16
77,47,212,1526,0.22169811320754718,7833.333333333333,61833.333333333336,2020-03-17
78,85,265,1791,0.32075471698113206,14166.666666666666,76000.0,2020-03-18
79,70,253,2044,0.2766798418972332,11666.666666666666,87666.66666666667,2020-03-19
80,104,385,2429,0.2701298701298701,17333.333333333332,105000.0,2020-03-20
81,94,329,2758,0.2857142857142857,15666.666666666666,120666.66666666667,2020-03-21
82,89,326,3084,0.27300613496932513,14833.333333333332,135500.0,2020-03-22
83,139,441,3525,0.31519274376417233,23166.666666666668,158666.66666666666,2020-03-23
84,110,371,3896,0.29649595687331537,18333.333333333332,177000.0,2020-03-24
85,120,377,4273,0.3183023872679045,20000.0,197000.0,2020-03-25
86,112,380,4653,0.29473684210526313,18666.666666666668,215666.66666666666,2020-03-26
87,104,350,5003,0.29714285714285715,17333.333333333332,233000.0,2020-03-27
88,112,379,5382,0.2955145118733509,18666.666666666668,251666.66666666666,2020-03-28
89,112,363,5745,0.3085399449035813,18666.666666666668,270333.3333333333,2020-03-29
90,127,418,6163,0.3038277511961722,21166.666666666668,291500.0,2020-03-30
91,110,365,6528,0.3013698630136986,18333.333333333332,309833.3333333333,2020-03-31
92,179,549,7077,0.32604735883424407,29833.333333333332,339666.6666666666,2020-04-01
93,149,419,7496,0.3556085918854415,24833.333333333332,364499.99999999994,2020-04-02
94,146,421,7917,0.34679334916864607,24333.333333333332,388833.33333333326,2020-04-03
95,159,439,8356,0.3621867881548975,26500.0,415333.33333333326,2020-04-04
96,160,450,8806,0.35555555555555557,26666.666666666668,441999.99999999994,2020-04-05
97,169,465,9271,0.3634408602150538,28166.666666666668,470166.6666666666,2020-04-06
98,171,475,9746,0.36,28500.0,498666.6666666666,2020-04-07
99,170,492,10238,0.34552845528455284,28333.333333333332,527000.0,2020-04-08
100,179,496,10734,0.36088709677419356,29833.333333333332,556833.3333333334,2020-04-09
101,229,687,11421,0.3333333333333333,38166.666666666664,595000.0,2020-04-10
102,187,506,11927,0.3695652173913043,31166.666666666664,626166.6666666666,2020-04-11
103,228,624,12551,0.36538461538461536,38000.0,664166.6666666666,2020-04-12
104,208,610,13161,0.34098360655737703,34666.666666666664,698833.3333333333,2020-04-13
105,261,656,13817,0.3978658536585366,43500.0,742333.3333333333,2020-04-14
106,283,771,14588,0.3670557717250324,47166.666666666664,789499.9999999999,2020-04-15
107,203,641,15229,0.3166926677067083,33833.333333333336,823333.3333333333,2020-04-16
108,262,715,15944,0.36643356643356645,43666.666666666664,866999.9999999999,2020-04-17
109,291,814,16758,0.3574938574938575,48500.0,915499.9999999999,2020-04-18
110,250,671,17429,0.37257824143070045,41666.666666666664,957166.6666666665,2020-04-19
111,394,1080,18509,0.3648148148148148,65666.66666666667,1022833.3333333331,2020-04-20
112,233,723,19232,0.32226832641770403,38833.333333333336,1061666.6666666665,2020-04-21
113,331,832,20064,0.39783653846153844,55166.666666666664,1116833.3333333333,2020-04-22
114,293,803,20867,0.36488169364881695,48833.333333333336,1165666.6666666665,2020-04-23
115,336,822,21689,0.40875912408759124,56000.0,1221666.6666666665,2020-04-24
116,314,892,22581,0.35201793721973096,52333.333333333336,1273999.9999999998,2020-04-25
117,302,764,23345,0.39528795811518325,50333.333333333336,1324333.333333333,2020-04-26
118,354,854,24199,0.41451990632318503,59000.0,1383333.333333333,2020-04-27
119,339,820,25019,0.41341463414634144,56500.0,1439833.333333333,2020-04-28
120,286,664,25683,0.4307228915662651,47666.666666666664,1487499.9999999998,2020-04-29
121,399,920,26603,0.43369565217391304,66500.0,1553999.9999999998,2020-04-30
122,487,1280,27883,0.38046875,81166.66666666667,1635166.6666666665,2020-05-01
123,320,820,28703,0.3902439024390244,53333.333333333336,1688499.9999999998,2020-05-02
124,337,858,29561,0.3927738927738928,56166.666666666664,1744666.6666666665,2020-05-03
125,376,910,30471,0.41318681318681316,62666.666666666664,1807333.3333333333,2020-05-04
126,365,885,31356,0.4124293785310734,60833.33333333333,1868166.6666666665,2020-05-05
127,289,771,32127,0.3748378728923476,48166.666666666664,1916333.3333333333,2020-05-06
128,307,821,32948,0.37393422655298414,51166.666666666664,1967500.0,2020-05-07
129,318,818,33766,0.38875305623471884,53000.0,2020500.0,2020-05-08
130,278,768,34534,0.3619791666666667,46333.333333333336,2066833.3333333333,2020-05-09
131,416,1120,35654,0.37142857142857144,69333.33333333333,2136166.6666666665,2020-05-10
132,297,817,36471,0.3635250917992656,49500.0,2185666.6666666665,2020-05-11
133,282,820,37291,0.3439024390243902,47000.0,2232666.6666666665,2020-05-12
134,312,769,38060,0.4057217165149545,52000.0,2284666.6666666665,2020-05-13
135,278,780,38840,0.3564102564102564,46333.333333333336,2331000.0,2020-05-14
136,307,847,39687,0.3624557260920897,51166.666666666664,2382166.6666666665,2020-05-15
137,259,789,40476,0.3282636248415716,43166.666666666664,2425333.333333333,2020-05-16
138,261,752,41228,0.3470744680851064,43500.0,2468833.333333333,2020-05-17
139,256,780,42008,0.3282051282051282,42666.666666666664,2511499.9999999995,2020-05-18
140,225,642,42650,0.35046728971962615,37500.0,2548999.9999999995,2020-05-19
141,323,894,43544,0.36129753914988816,53833.333333333336,2602833.333333333,2020-05-20
142,232,638,44182,0.36363636363636365,38666.666666666664,2641499.9999999995,2020-05-21
143,215,618,44800,0.3478964401294498,35833.333333333336,2677333.333333333,2020-05-22
144,188,544,45344,0.34558823529411764,31333.333333333332,2708666.6666666665,2020-05-23
145,222,562,45906,0.39501779359430605,37000.0,2745666.6666666665,2020-05-24
146,276,767,46673,0.35984354628422427,46000.0,2791666.6666666665,2020-05-25
147,198,597,47270,0.3316582914572864,33000.0,2824666.6666666665,2020-05-26
148,164,539,47809,0.3042671614100185,27333.333333333332,2852000.0,2020-05-27
149,198,604,48413,0.32781456953642385,33000.0,2885000.0,2020-05-28
150,186,544,48957,0.34191176470588236,31000.0,2916000.0,2020-05-29
151,182,576,49533,0.3159722222222222,30333.333333333332,2946333.3333333335,2020-05-30
152,175,544,50077,0.32169117647058826,29166.666666666664,2975500.0,2020-05-31
153,279,885,50962,0.3152542372881356,46500.0,3022000.0,2020-06-01
154,207,600,51562,0.345,34500.0,3056500.0,2020-06-02
155,172,539,52101,0.31910946196660483,28666.666666666668,3085166.6666666665,2020-06-03
156,182,571,52672,0.318739054290718,30333.333333333332,3115500.0,2020-06-04
157,191,639,53311,0.29890453834115804,31833.333333333332,3147333.3333333335,2020-06-05
158,174,543,53854,0.32044198895027626,29000.0,3176333.3333333335,2020-06-06
159,148,501,54355,0.2954091816367265,24666.666666666668,3201000.0,2020-06-07
160,173,575,54930,0.3008695652173913,28833.333333333332,3229833.3333333335,2020-06-08
161,159,541,55471,0.29390018484288355,26500.0,3256333.3333333335,2020-06-09
162,186,670,56141,0.27761194029850744,31000.0,3287333.3333333335,2020-06-10
163,164,507,56648,0.3234714003944773,27333.333333333332,3314666.666666667,2020-06-11
164,149,546,57194,0.27289377289377287,24833.333333333332,3339500.0000000005,2020-06-12
165,156,484,57678,0.32231404958677684,26000.0,3365500.0000000005,2020-06-13
166,158,500,58178,0.316,26333.333333333332,3391833.333333334,2020-06-14
167,175,567,58745,0.30864197530864196,29166.666666666664,3421000.0000000005,2020-06-15
168,152,485,59230,0.3134020618556701,25333.333333333332,3446333.333333334,2020-06-16
169,146,491,59721,0.2973523421588595,24333.333333333332,3470666.6666666674,2020-06-17
170,152,521,60242,0.29174664107485604,25333.333333333332,3496000.000000001,2020-06-18
171,154,500,60742,0.308,25666.666666666668,3521666.6666666674,2020-06-19
172,216,679,61421,0.3181148748159057,36000.0,3557666.6666666674,2020-06-20
173,134,436,61857,0.3073394495412844,22333.333333333332,3580000.000000001,2020-06-21
174,150,545,62402,0.27522935779816515,25000.0,3605000.000000001,2020-06-22
175,149,488,62890,0.305327868852459,24833.333333333332,3629833.3333333344,2020-06-23
176,145,491,63381,0.2953156822810591,24166.666666666668,3654000.000000001,2020-06-24
177,161,573,63954,0.28097731239092494,26833.333333333332,3680833.3333333344,2020-06-25
178,163,555,64509,0.2936936936936937,27166.666666666668,3708000.000000001,2020-06-26
179,156,453,64962,0.3443708609271523,26000.0,3734000.000000001,2020-06-27
180,141,493,65455,0.28600405679513186,23500.0,3757500.000000001,2020-06-28
181,157,493,65948,0.3184584178498986,26166.666666666668,3783666.6666666674,2020-06-29
182,166,546,66494,0.304029304029304,27666.666666666668,3811333.333333334,2020-06-30
183,249,819,67313,0.304029304029304,41500.0,3852833.333333334,2020-07-01
184,172,543,67856,0.31675874769797424,28666.666666666668,3881500.0000000005,2020-07-02
185,180,628,68484,0.28662420382165604,30000.0,3911500.0000000005,2020-07-03
186,149,492,68976,0.30284552845528456,24833.333333333332,3936333.333333334,2020-07-04
187,162,547,69523,0.2961608775137112,27000.0,3963333.333333334,2020-07-05
188,192,600,70123,0.32,32000.0,3995333.333333334,2020-07-06
189,163,560,70683,0.2910714285714286,27166.666666666668,4022500.0000000005,2020-07-07
190,177,535,71218,0.33084112149532713,29500.0,4052000.0000000005,2020-07-08
191,151,538,71756,0.28066914498141265,25166.666666666668,4077166.666666667,2020-07-09
192,244,786,72542,0.3104325699745547,40666.666666666664,4117833.3333333335,2020-07-10
193,121,479,73021,0.25260960334029225,20166.666666666668,4138000.0,2020-07-11
194,146,455,73476,0.3208791208791209,24333.333333333332,4162333.3333333335,2020-07-12
195,164,555,74031,0.2954954954954955,27333.333333333332,4189666.666666667,2020-07-13
196,149,470,74501,0.3170212765957447,24833.333333333332,4214500.0,2020-07-14
197,161,560,75061,0.2875,26833.333333333332,4241333.333333333,2020-07-15
198,142,503,75564,0.2823061630218688,23666.666666666668,4265000.0,2020-07-16
199,143,526,76090,0.2718631178707224,23833.333333333332,4288833.333333333,2020-07-17
200,139,474,76564,0.29324894514767935,23166.666666666668,4312000.0,2020-07-18
201,143,443,77007,0.3227990970654628,23833.333333333332,4335833.333333333,2020-07-19
202,205,754,77761,0.2718832891246684,34166.666666666664,4370000.0,2020-07-20
203,172,524,78285,0.3282442748091603,28666.666666666668,4398666.666666667,2020-07-21
204,165,513,78798,0.3216374269005848,27500.0,4426166.666666667,2020-07-22
205,135,517,79315,0.2611218568665377,22500.0,4448666.666666667,2020-07-23
206,163,523,79838,0.31166347992351817,27166.666666666668,4475833.333333334,2020-07-24
207,169,572,80410,0.29545454545454547,28166.666666666668,4504000.000000001,2020-07-25
208,138,457,80867,0.30196936542669583,23000.0,4527000.000000001,2020-07-26
209,181,605,81472,0.2991735537190083,30166.666666666664,4557166.666666668,2020-07-27
210,150,481,81953,0.31185031185031187,25000.0,4582166.666666668,2020-07-28
211,116,428,82381,0.27102803738317754,19333.333333333332,4601500.000000001,2020-07-29
212,148,494,82875,0.29959514170040485,24666.666666666668,4626166.666666668,2020-07-30
213,133,482,83357,0.27593360995850624,22166.666666666668,4648333.333333335,2020-07-31
214,221,761,84118,0.290407358738502,36833.333333333336,4685166.666666668,2020-08-01
215,144,451,84569,0.31929046563192903,24000.0,4709166.666666668,2020-08-02
216,140,507,85076,0.27613412228796846,23333.333333333332,4732500.000000001,2020-08-03
217,118,430,85506,0.2744186046511628,19666.666666666668,4752166.666666668,2020-08-04
218,128,456,85962,0.2807017543859649,21333.333333333332,4773500.000000001,2020-08-05
219,122,432,86394,0.2824074074074074,20333.333333333332,4793833.333333334,2020-08-06
220,130,483,86877,0.2691511387163561,21666.666666666668,4815500.000000001,2020-08-07
221,136,490,87367,0.27755102040816326,22666.666666666668,4838166.666666668,2020-08-08
222,121,403,87770,0.3002481389578164,20166.666666666668,4858333.333333335,2020-08-09
223,216,682,88452,0.31671554252199413,36000.0,4894333.333333335,2020-08-10
224,116,408,88860,0.28431372549019607,19333.333333333332,4913666.666666668,2020-08-11
225,120,408,89268,0.29411764705882354,20000.0,4933666.666666668,2020-08-12
226,127,439,89707,0.28929384965831434,21166.666666666668,4954833.333333335,2020-08-13
227,119,458,90165,0.259825327510917,19833.333333333332,4974666.666666668,2020-08-14
228,138,460,90625,0.3,23000.0,4997666.666666668,2020-08-15
229,124,395,91020,0.3139240506329114,20666.666666666668,5018333.333333335,2020-08-16
230,119,435,91455,0.2735632183908046,19833.333333333332,5038166.666666668,2020-08-17
231,122,453,91908,0.2693156732891832,20333.333333333332,5058500.000000001,2020-08-18
232,122,414,92322,0.2946859903381642,20333.333333333332,5078833.333333334,2020-08-19
233,161,547,92869,0.2943327239488117,26833.333333333332,5105666.666666667,2020-08-20
234,125,433,93302,0.28868360277136257,20833.333333333332,5126500.0,2020-08-21
235,121,414,93716,0.2922705314009662,20166.666666666668,5146666.666666667,2020-08-22
236,105,385,94101,0.2727272727272727,17500.0,5164166.666666667,2020-08-23
237,125,467,94568,0.2676659528907923,20833.333333333332,5185000.0,2020-08-24
238,127,468,95036,0.27136752136752135,21166.666666666668,5206166.666666667,2020-08-25
239,130,442,95478,0.29411764705882354,21666.666666666668,5227833.333333334,2020-08-26
240,117,407,95885,0.28746928746928746,19500.0,5247333.333333334,2020-08-27
241,140,483,96368,0.2898550724637681,23333.333333333332,5270666.666666667,2020-08-28
242,105,373,96741,0.28150134048257375,17500.0,5288166.666666667,2020-08-29
243,108,350,97091,0.30857142857142855,18000.0,5306166.666666667,2020-08-30
244,134,431,97522,0.3109048723897912,22333.333333333332,5328500.0,2020-08-31
245,171,636,98158,0.2688679245283019,28500.0,5357000.0,2020-09-01
246,114,418,98576,0.2727272727272727,19000.0,5376000.0,2020-09-02
247,132,409,98985,0.32273838630806845,22000.0,5398000.0,2020-09-03
248,126,426,99411,0.29577464788732394,21000.0,5419000.0,2020-09-04
249,131,434,99845,0.30184331797235026,21833.333333333332,5440833.333333333,2020-09-05
250,101,338,100183,0.2988165680473373,16833.333333333332,5457666.666666666,2020-09-06
251,113,429,100612,0.2634032634032634,18833.333333333332,5476499.999999999,2020-09-07
252,106,397,101009,0.26700251889168763,17666.666666666668,5494166.666666666,2020-09-08
253,113,348,101357,0.32471264367816094,18833.333333333332,5512999.999999999,2020-09-09
254,135,902,102259,0.14966740576496673,22500.0,5535499.999999999,2020-09-10
255,99,358,102617,0.276536312849162,16500.0,5551999.999999999,2020-09-11
256,83,316,102933,0.2626582278481013,13833.333333333334,5565833.333333332,2020-09-12
257,97,333,103266,0.2912912912912913,16166.666666666666,5581999.999999999,2020-09-13
258,121,415,103681,0.29156626506024097,20166.666666666668,5602166.666666666,2020-09-14
259,106,373,104054,0.28418230563002683,17666.666666666668,5619833.333333333,2020-09-15
260,87,322,104376,0.2701863354037267,14500.0,5634333.333333333,2020-09-16
261,100,339,104715,0.2949852507374631,16666.666666666668,5651000.0,2020-09-17
262,98,345,105060,0.28405797101449276,16333.333333333332,5667333.333333333,2020-09-18
263,79,286,105346,0.2762237762237762,13166.666666666666,5680500.0,2020-09-19
264,119,426,105772,0.2793427230046948,19833.333333333332,5700333.333333333,2020-09-20
265,82,303,106075,0.2706270627062706,13666.666666666666,5714000.0,2020-09-21
266,84,298,106373,0.28187919463087246,14000.0,5728000.0,2020-09-22
267,101,316,106689,0.31962025316455694,16833.333333333332,5744833.333333333,2020-09-23
268,76,270,106959,0.2814814814814815,12666.666666666666,5757500.0,2020-09-24
269,86,359,107318,0.2395543175487465,14333.333333333334,5771833.333333333,2020-09-25
270,81,277,107595,0.2924187725631769,13500.0,5785333.333333333,2020-09-26
271,59,266,107861,0.22180451127819548,9833.333333333334,5795166.666666666,2020-09-27
272,72,323,108184,0.22291021671826625,12000.0,5807166.666666666,2020-09-28
273,80,291,108475,0.27491408934707906,13333.333333333334,5820499.999999999,2020-09-29
274,95,311,108786,0.3054662379421222,15833.333333333332,5836333.333333332,2020-09-30
275,137,457,109243,0.29978118161925604,22833.333333333332,5859166.666666665,2020-10-01
276,101,297,109540,0.3400673400673401,16833.333333333332,5875999.999999998,2020-10-02
277,72,252,109792,0.2857142857142857,12000.0,5887999.999999998,2020-10-03
278,71,257,110049,0.27626459143968873,11833.333333333334,5899833.333333331,2020-10-04
279,86,301,110350,0.2857142857142857,14333.333333333334,5914166.666666664,2020-10-05
280,92,290,110640,0.31724137931034485,15333.333333333332,5929499.999999997,2020-10-06
281,78,263,110903,0.2965779467680608,13000.0,5942499.999999997,2020-10-07
282,78,260,111163,0.3,13000.0,5955499.999999997,2020-10-08
283,77,293,111456,0.2627986348122867,12833.333333333334,5968333.33333333,2020-10-09
284,106,393,111849,0.2697201017811705,17666.666666666668,5985999.999999997,2020-10-10
285,68,239,112088,0.28451882845188287,11333.333333333334,5997333.33333333,2020-10-11
286,69,261,112349,0.26436781609195403,11500.0,6008833.33333333,2020-10-12
287,66,291,112640,0.2268041237113402,11000.0,6019833.33333333,2020-10-13
288,66,275,112915,0.24,11000.0,6030833.33333333,2020-10-14
289,80,335,113250,0.23880597014925373,13333.333333333334,6044166.666666663,2020-10-15
290,78,295,113545,0.26440677966101694,13000.0,6057166.666666663,2020-10-16
291,65,250,113795,0.26,10833.333333333334,6067999.999999996,2020-10-17
292,71,284,114079,0.25,11833.333333333334,6079833.333333329,2020-10-18
293,78,274,114353,0.2846715328467153,13000.0,6092833.333333329,2020-10-19
294,101,382,114735,0.2643979057591623,16833.333333333332,6109666.666666662,2020-10-20
295,63,262,114997,0.24045801526717558,10500.0,6120166.666666662,2020-10-21
296,70,287,115284,0.24390243902439024,11666.666666666666,6131833.333333329,2020-10-22
297,81,301,115585,0.2691029900332226,13500.0,6145333.333333329,2020-10-23
298,72,263,115848,0.2737642585551331,12000.0,6157333.333333329,2020-10-24
299,77,312,116160,0.2467948717948718,12833.333333333334,6170166.666666662,2020-10-25
300,65,325,116485,0.2,10833.333333333334,6180999.999999995,2020-10-26
301,72,318,116803,0.22641509433962265,12000.0,6192999.999999995,2020-10-27
302,93,334,117137,0.27844311377245506,15500.0,6208499.999999995,2020-10-28
303,80,306,117443,0.26143790849673204,13333.333333333334,6221833.333333328,2020-10-29
304,88,365,117808,0.2410958904109589,14666.666666666666,6236499.999999995,2020-10-30
305,79,276,118084,0.286231884057971,13166.666666666666,6249666.666666662,2020-10-31
306,123,548,118632,0.22445255474452555,20500.0,6270166.666666662,2020-11-01
307,94,388,119020,0.2422680412371134,15666.666666666666,6285833.333333329,2020-11-02
308,87,361,119381,0.2409972299168975,14500.0,6300333.333333329,2020-11-03
309,82,451,119832,0.18181818181818182,13666.666666666666,6313999.999999996,2020-11-04
310,105,492,120324,0.21341463414634146,17500.0,6331499.999999996,2020-11-05
311,133,532,120856,0.25,22166.666666666668,6353666.666666663,2020-11-06
312,124,466,121322,0.26609442060085836,20666.666666666668,6374333.33333333,2020-11-07
313,126,500,121822,0.252,21000.0,6395333.33333333,2020-11-08
314,138,575,122397,0.24,23000.0,6418333.33333333,2020-11-09
315,162,617,123014,0.2625607779578606,27000.0,6445333.33333333,2020-11-10
316,112,538,123552,0.20817843866171004,18666.666666666668,6463999.999999997,2020-11-11
317,112,529,124081,0.21172022684310018,18666.666666666668,6482666.666666664,2020-11-12
318,116,563,124644,0.20603907637655416,19333.333333333332,6501999.999999997,2020-11-13
319,130,554,125198,0.23465703971119134,21666.666666666668,6523666.666666664,2020-11-14
320,160,674,125872,0.23738872403560832,26666.666666666668,6550333.333333331,2020-11-15
321,158,640,126512,0.246875,26333.333333333332,6576666.666666664,2020-11-16
322,147,569,127081,0.2583479789103691,24500.0,6601166.666666664,2020-11-17
323,165,598,127679,0.27591973244147155,27500.0,6628666.666666664,2020-11-18
324,157,603,128282,0.2603648424543947,26166.666666666668,6654833.333333331,2020-11-19
325,249,945,129227,0.2634920634920635,41500.0,6696333.333333331,2020-11-20
326,162,643,129870,0.25194401244167963,27000.0,6723333.333333331,2020-11-21
327,145,627,130497,0.23125996810207336,24166.666666666668,6747499.999999998,2020-11-22
328,168,816,131313,0.20588235294117646,28000.0,6775499.999999998,2020-11-23
329,155,655,131968,0.2366412213740458,25833.333333333332,6801333.333333331,2020-11-24
330,229,818,132786,0.27995110024449876,38166.666666666664,6839499.999999998,2020-11-25
331,163,681,133467,0.2393538913362702,27166.666666666668,6866666.666666665,2020-11-26
332,203,745,134212,0.27248322147651005,33833.333333333336,6900499.999999998,2020-11-27
333,168,629,134841,0.2670906200317965,28000.0,6928499.999999998,2020-11-28
334,147,583,135424,0.2521440823327616,24500.0,6952999.999999998,2020-11-29
335,217,817,136241,0.26560587515299877,36166.666666666664,6989166.666666665,2020-11-30
336,325,1184,137425,0.27449324324324326,54166.666666666664,7043333.333333332,2020-12-01
337,223,759,138184,0.2938076416337286,37166.666666666664,7080499.999999999,2020-12-02
338,225,735,138919,0.30612244897959184,37500.0,7117999.999999999,2020-12-03
339,202,766,139685,0.26370757180156656,33666.666666666664,7151666.666666666,2020-12-04
340,213,802,140487,0.2655860349127182,35500.0,7187166.666666666,2020-12-05
341,176,694,141181,0.25360230547550433,29333.333333333332,7216499.999999999,2020-12-06
342,213,800,141981,0.26625,35500.0,7251999.999999999,2020-12-07
343,201,784,142765,0.25637755102040816,33500.0,7285499.999999999,2020-12-08
344,207,756,143521,0.27380952380952384,34500.0,7319999.999999999,2020-12-09
345,278,1017,144538,0.27335299901671584,46333.333333333336,7366333.333333332,2020-12-10
346,185,719,145257,0.2573018080667594,30833.333333333332,7397166.666666665,2020-12-11
347,201,767,146024,0.2620599739243807,33500.0,7430666.666666665,2020-12-12
348,185,719,146743,0.2573018080667594,30833.333333333332,7461499.999999998,2020-12-13
349,193,793,147536,0.24337957124842372,32166.666666666664,7493666.666666665,2020-12-14
350,236,799,148335,0.295369211514393,39333.333333333336,7532999.999999998,2020-12-15
351,184,684,149019,0.26900584795321636,30666.666666666664,7563666.666666665,2020-12-16
352,186,741,149760,0.25101214574898784,31000.0,7594666.666666665,2020-12-17
353,213,821,150581,0.25943970767356883,35500.0,7630166.666666665,2020-12-18
354,157,689,151270,0.22786647314949202,26166.666666666668,7656333.333333332,2020-12-19
355,241,987,152257,0.24417426545086118,40166.666666666664,7696499.999999999,2020-12-20
356,200,791,153048,0.2528445006321112,33333.333333333336,7729833.333333332,2020-12-21
357,179,730,153778,0.2452054794520548,29833.333333333332,7759666.666666665,2020-12-22
358,172,856,154634,0.20093457943925233,28666.666666666668,7788333.333333332,2020-12-23
359,184,840,155474,0.21904761904761905,30666.666666666664,7818999.999999999,2020-12-24
360,218,1083,156557,0.2012927054478301,36333.333333333336,7855333.333333332,2020-12-25
361,187,919,157476,0.20348204570184983,31166.666666666664,7886499.999999999,2020-12-26
362,185,954,158430,0.19392033542976939,30833.333333333332,7917333.333333332,2020-12-27
363,237,1055,159485,0.22464454976303316,39500.0,7956833.333333332,2020-12-28
364,175,825,160310,0.21212121212121213,29166.666666666664,7985999.999999999,2020-12-29
365,175,954,161264,0.18343815513626835,29166.666666666664,8015166.666666666,2020-12-30
366,207,918,162182,0.22549019607843138,34500.0,8049666.666666666,2020-12-31
367,288,1648,163830,0.17475728155339806,48000.0,8097666.666666666,2021-01-01
368,209,1294,165124,0.1615146831530139,34833.333333333336,8132499.999999999,2021-01-02
369,242,1330,166454,0.18195488721804512,40333.333333333336,8172833.333333332,2021-01-03
370,240,1491,167945,0.16096579476861167,40000.0,8212833.333333332,2021-01-04
371,245,1386,169331,0.17676767676767677,40833.333333333336,8253666.666666665,2021-01-05
372,209,1217,170548,0.17173377156943304,34833.333333333336,8288499.999999998,2021-01-06
373,233,1196,171744,0.1948160535117057,38833.333333333336,8327333.333333331,2021-01-07
374,207,1296,173040,0.1597222222222222,34500.0,8361833.333333331,2021-01-08
375,184,1156,174196,0.15916955017301038,30666.666666666664,8392499.999999998,2021-01-09
376,266,1484,175680,0.1792452830188679,44333.333333333336,8436833.333333332,2021-01-10
377,181,1145,176825,0.15807860262008733,30166.666666666664,8466999.999999998,2021-01-11
378,176,1182,178007,0.14890016920473773,29333.333333333332,8496333.333333332,2021-01-12
379,173,1078,179085,0.16048237476808905,28833.333333333332,8525166.666666666,2021-01-13
380,180,1070,180155,0.16822429906542055,30000.0,8555166.666666666,2021-01-14
381,213,1330,181485,0.16015037593984963,35500.0,8590666.666666666,2021-01-15
382,151,1011,182496,0.1493570722057369,25166.666666666668,8615833.333333332,2021-01-16
383,161,982,183478,0.16395112016293278,26833.333333333332,8642666.666666666,2021-01-17
384,176,1278,184756,0.13771517996870108,29333.333333333332,8672000.0,2021-01-18
385,131,1005,185761,0.13034825870646766,21833.333333333332,8693833.333333334,2021-01-19
386,207,1427,187188,0.14505956552207427,34500.0,8728333.333333334,2021-01-20
387,147,1055,188243,0.13933649289099526,24500.0,8752833.333333334,2021-01-21
388,153,1114,189357,0.13734290843806105,25500.0,8778333.333333334,2021-01-22
389,142,993,190350,0.14300100704934543,23666.666666666668,8802000.0,2021-01-23
390,124,953,191303,0.13011542497376705,20666.666666666668,8822666.666666666,2021-01-24
391,162,1320,192623,0.12272727272727273,27000.0,8849666.666666666,2021-01-25
392,150,1109,193732,0.13525698827772767,25000.0,8874666.666666666,2021-01-26
393,122,1025,194757,0.11902439024390243,20333.333333333332,8895000.0,2021-01-27
394,139,1157,195914,0.12013828867761452,23166.666666666668,8918166.666666666,2021-01-28
395,140,1109,197023,0.12623985572587917,23333.333333333332,8941500.0,2021-01-29
396,122,1015,198038,0.12019704433497537,20333.333333333332,8961833.333333334,2021-01-30
397,148,1120,199158,0.13214285714285715,24666.666666666668,8986500.0,2021-01-31
398,249,2316,201474,0.10751295336787564,41500.0,9028000.0,2021-02-01
399,150,1735,203209,0.08645533141210375,25000.0,9053000.0,2021-02-02
400,158,1908,205117,0.08280922431865828,26333.333333333332,9079333.333333334,2021-02-03
401,122,2052,207169,0.0594541910331384,20333.333333333332,9099666.666666668,2021-02-04
402,178,2897,210066,0.06144287193648602,29666.666666666664,9129333.333333334,2021-02-05
403,145,2855,212921,0.050788091068301226,24166.666666666668,9153500.0,2021-02-06
404,155,3409,216330,0.04546787914344382,25833.333333333332,9179333.333333334,2021-02-07
405,184,4411,220741,0.041713897075493084,30666.666666666664,9210000.0,2021-02-08
406,172,3774,224515,0.04557498675145734,28666.666666666668,9238666.666666666,2021-02-09
407,246,4601,229116,0.05346663768745925,41000.0,9279666.666666666,2021-02-10
408,164,3815,232931,0.042988204456094366,27333.333333333332,9307000.0,2021-02-11
409,239,4819,237750,0.049595351732724634,39833.333333333336,9346833.333333334,2021-02-12
410,184,4440,242190,0.04144144144144144,30666.666666666664,9377500.0,2021-02-13
411,209,4696,246886,0.04450596252129472,34833.333333333336,9412333.333333334,2021-02-14
412,297,6102,252988,0.048672566371681415,49500.0,9461833.333333334,2021-02-15
413,234,4829,257817,0.048457237523296746,39000.0,9500833.333333334,2021-02-16
414,254,5162,262979,0.049205734211545914,42333.333333333336,9543166.666666668,2021-02-17
415,327,6039,269018,0.05414803775459513,54500.0,9597666.666666668,2021-02-18
416,287,6158,275176,0.0466060409223774,47833.333333333336,9645500.000000002,2021-02-19
417,395,6776,281952,0.058293978748524204,65833.33333333333,9711333.333333336,2021-02-20
418,274,5377,287329,0.05095778315045565,45666.666666666664,9757000.000000002,2021-02-21
419,357,7127,294456,0.05009120246948225,59500.0,9816500.000000002,2021-02-22
420,314,5903,300359,0.053193291546671184,52333.333333333336,9868833.333333336,2021-02-23
421,356,5846,306205,0.06089633937735203,59333.33333333333,9928166.66666667,2021-02-24
422,396,6985,313190,0.05669291338582677,66000.0,9994166.66666667,2021-02-25
423,340,7594,320784,0.04477218856992363,56666.666666666664,10050833.333333336,2021-02-26
424,329,6833,327617,0.04814869018000878,54833.333333333336,10105666.66666667,2021-02-27
425,441,8263,335880,0.05337044656904272,73500.0,10179166.66666667,2021-02-28
426,790,11854,347734,0.06664417074405264,131666.66666666666,10310833.333333336,2021-03-01
427,471,7685,355419,0.06128822381262199,78500.0,10389333.333333336,2021-03-02
428,474,7494,362913,0.0632506004803843,79000.0,10468333.333333336,2021-03-03
429,468,7664,370577,0.061064718162839246,78000.0,10546333.333333336,2021-03-04
430,586,10101,380678,0.05801405801405801,97666.66666666667,10644000.000000002,2021-03-05
431,518,8825,389503,0.05869688385269122,86333.33333333333,10730333.333333336,2021-03-06
432,503,8243,397746,0.06102147276477011,83833.33333333333,10814166.66666667,2021-03-07
433,649,10923,408669,0.059415911379657606,108166.66666666667,10922333.333333336,2021-03-08
434,548,8901,417570,0.06156611616672284,91333.33333333333,11013666.66666667,2021-03-09
435,846,10677,428247,0.07923574037651025,141000.0,11154666.66666667,2021-03-10
436,547,8273,436520,0.0661186993835368,91166.66666666667,11245833.333333336,2021-03-11
437,646,10115,446635,0.06386554621848739,107666.66666666667,11353500.000000002,2021-03-12
438,565,8948,455583,0.06314260169870362,94166.66666666667,11447666.666666668,2021-03-13
439,590,8942,464525,0.06598076492954597,98333.33333333333,11546000.000000002,2021-03-14
440,784,11049,475574,0.07095664766042176,130666.66666666666,11676666.666666668,2021-03-15
441,582,8142,483716,0.07148120854826824,97000.0,11773666.666666668,2021-03-16
442,589,7740,491456,0.07609819121447028,98166.66666666667,11871833.333333334,2021-03-17
443,581,8040,499496,0.0722636815920398,96833.33333333333,11968666.666666668,2021-03-18
444,575,9050,508546,0.06353591160220995,95833.33333333333,12064500.000000002,2021-03-19
445,735,9533,518079,0.0771005979230043,122500.0,12187000.000000002,2021-03-20
446,467,7319,525398,0.06380653094685067,77833.33333333333,12264833.333333336,2021-03-21
447,532,8455,533853,0.06292134831460675,88666.66666666667,12353500.000000002,2021-03-22
448,453,6918,540771,0.06548135299219428,75500.0,12429000.000000002,2021-03-23
449,436,6280,547051,0.06942675159235669,72666.66666666667,12501666.666666668,2021-03-24
450,496,6992,554043,0.07093821510297482,82666.66666666667,12584333.333333334,2021-03-25
451,475,7156,561199,0.06637786472889882,79166.66666666667,12663500.0,2021-03-26
452,400,6117,567316,0.06539153179663233,66666.66666666667,12730166.666666666,2021-03-27
453,425,5544,572860,0.07665945165945166,70833.33333333333,12801000.0,2021-03-28
454,409,5807,578667,0.07043223695539866,68166.66666666667,12869166.666666666,2021-03-29
455,415,5044,583711,0.08227597145122918,69166.66666666667,12938333.333333332,2021-03-30
456,341,4863,588574,0.07012132428542052,56833.333333333336,12995166.666666666,2021-03-31
457,643,7372,595946,0.08722192078133478,107166.66666666667,13102333.333333332,2021-04-01
458,377,5883,601829,0.06408295087540371,62833.33333333333,13165166.666666666,2021-04-02
459,374,5362,607191,0.06975009324878777,62333.33333333333,13227500.0,2021-04-03
460,369,5338,612529,0.06912701386286998,61500.0,13289000.0,2021-04-04
461,419,6751,619280,0.062064879277144124,69833.33333333333,13358833.333333334,2021-04-05
462,334,5000,624280,0.0668,55666.666666666664,13414500.0,2021-04-06
463,280,4803,629083,0.05829689777222569,46666.666666666664,13461166.666666666,2021-04-07
464,362,5177,634260,0.06992466679544138,60333.33333333333,13521500.0,2021-04-08
465,339,5880,640140,0.05765306122448979,56500.0,13578000.0,2021-04-09
466,447,6250,646390,0.07152,74500.0,13652500.0,2021-04-10
467,298,4861,651251,0.06130425838304875,49666.666666666664,13702166.666666666,2021-04-11
468,370,6040,657291,0.061258278145695365,61666.666666666664,13763833.333333332,2021-04-12
469,299,4731,662022,0.0632001690974424,49833.333333333336,13813666.666666666,2021-04-13
470,292,4609,666631,0.06335430679106097,48666.666666666664,13862333.333333332,2021-04-14
471,325,5020,671651,0.0647410358565737,54166.666666666664,13916499.999999998,2021-04-15
472,286,5149,676800,0.05554476597397553,47666.666666666664,13964166.666666664,2021-04-16
473,278,4544,681344,0.061179577464788734,46333.333333333336,14010499.999999998,2021-04-17
474,276,4350,685694,0.06344827586206897,46000.0,14056499.999999998,2021-04-18
475,276,5287,690981,0.052203518063173825,46000.0,14102499.999999998,2021-04-19
476,423,5533,696514,0.07645038857762516,70500.0,14172999.999999998,2021-04-20
477,227,4191,700705,0.05416368408494393,37833.333333333336,14210833.333333332,2021-04-21
478,259,4493,705198,0.05764522590696639,43166.666666666664,14253999.999999998,2021-04-22
479,303,5202,710400,0.058246828143021914,50500.0,14304499.999999998,2021-04-23
480,288,4972,715372,0.057924376508447305,48000.0,14352499.999999998,2021-04-24
481,268,4905,720277,0.054638124362895,44666.666666666664,14397166.666666664,2021-04-25
482,277,5412,725689,0.05118255728011826,46166.666666666664,14443333.33333333,2021-04-26
483,265,4442,730131,0.05965781179648807,44166.666666666664,14487499.999999996,2021-04-27
484,276,4394,734525,0.06281292671825216,46000.0,14533499.999999996,2021-04-28
485,239,4006,738531,0.059660509236145784,39833.333333333336,14573333.33333333,2021-04-29
486,292,5381,743912,0.05426500650436722,48666.666666666664,14621999.999999996,2021-04-30
487,420,6422,750334,0.06540018685767673,70000.0,14691999.999999996,2021-05-01
488,244,5022,755356,0.04858622062923138,40666.666666666664,14732666.666666662,2021-05-02
489,319,6076,761432,0.05250164581961817,53166.666666666664,14785833.333333328,2021-05-03
490,255,4969,766401,0.05131817267055746,42500.0,14828333.333333328,2021-05-04
491,287,5073,771474,0.056574019317957816,47833.333333333336,14876166.666666662,2021-05-05
492,257,4773,776247,0.05384454221663524,42833.333333333336,14918999.999999996,2021-05-06
493,250,5593,781840,0.04469873055605221,41666.666666666664,14960666.666666662,2021-05-07
494,285,5268,787108,0.0541002277904328,47500.0,15008166.666666662,2021-05-08
495,310,5557,792665,0.055785495771099515,51666.666666666664,15059833.333333328,2021-05-09
496,437,7583,800248,0.057628906765132534,72833.33333333333,15132666.666666662,2021-05-10
497,280,5081,805329,0.055107262349931116,46666.666666666664,15179333.333333328,2021-05-11
498,287,5262,810591,0.054541999239832765,47833.333333333336,15227166.666666662,2021-05-12
499,239,5178,815769,0.04615681730397837,39833.333333333336,15266999.999999996,2021-05-13
500,306,6341,822110,0.04825737265415549,51000.0,15317999.999999996,2021-05-14
501,321,6443,828553,0.049821511718143724,53500.0,15371499.999999996,2021-05-15
502,287,5679,834232,0.05053706638492692,47833.333333333336,15419333.33333333,2021-05-16
503,311,6716,840948,0.04630732578916021,51833.333333333336,15471166.666666664,2021-05-17
504,305,5840,846788,0.052226027397260275,50833.333333333336,15521999.999999998,2021-05-18
505,273,5466,852254,0.049945115257958285,45500.0,15567499.999999998,2021-05-19
506,382,6816,859070,0.05604460093896713,63666.666666666664,15631166.666666664,2021-05-20
507,288,6239,865309,0.04616124378906876,48000.0,15679166.666666664,2021-05-21
508,253,5677,870986,0.044565791791439144,42166.666666666664,15721333.33333333,2021-05-22
509,258,5694,876680,0.045310853530031614,43000.0,15764333.33333333,2021-05-23
510,304,7056,883736,0.04308390022675737,50666.666666666664,15814999.999999996,2021-05-24
511,331,6935,890671,0.04772891131939438,55166.666666666664,15870166.666666662,2021-05-25
512,256,5937,896608,0.04311942058278592,42666.666666666664,15912833.333333328,2021-05-26
513,272,5860,902468,0.04641638225255973,45333.333333333336,15958166.666666662,2021-05-27
514,286,6982,909450,0.040962474935548554,47666.666666666664,16005833.333333328,2021-05-28
515,227,5852,915302,0.03879015721120984,37833.333333333336,16043666.666666662,2021-05-29
516,196,5442,920744,0.03601617052554208,32666.666666666664,16076333.333333328,2021-05-30
517,268,6493,927237,0.041275219467118436,44666.666666666664,16120999.999999994,2021-05-31
518,373,7795,935032,0.04785118665811418,62166.666666666664,16183166.66666666,2021-06-01
519,269,5819,940851,0.046227874205189895,44833.333333333336,16227999.999999994,2021-06-02
520,238,5275,946126,0.045118483412322274,39666.666666666664,16267666.66666666,2021-06-03
521,272,6417,952543,0.04238740844631448,45333.333333333336,16312999.999999994,2021-06-04
522,225,6200,958743,0.036290322580645164,37500.0,16350499.999999994,2021-06-05
523,219,5791,964534,0.03781730271110344,36500.0,16386999.999999994,2021-06-06
524,246,6527,971061,0.037689597058372916,41000.0,16427999.999999994,2021-06-07
525,230,5265,976326,0.04368471035137702,38333.333333333336,16466333.333333328,2021-06-08
526,207,4865,981191,0.04254881808838643,34500.0,16500833.333333328,2021-06-09
527,256,5745,986936,0.04456048738033072,42666.666666666664,16543499.999999994,2021-06-10
528,170,5299,992235,0.03208152481600302,28333.333333333332,16571833.333333328,2021-06-11
529,191,4882,997117,0.03912331011880377,31833.333333333332,16603666.666666662,2021-06-12
530,181,4608,1001725,0.03927951388888889,30166.666666666664,16633833.333333328,2021-06-13
531,202,5672,1007397,0.03561354019746121,33666.666666666664,16667499.999999994,2021-06-14
532,190,4915,1012312,0.038657171922685654,31666.666666666664,16699166.66666666,2021-06-15
533,147,4071,1016383,0.03610906411201179,24500.0,16723666.66666666,2021-06-16
534,147,4056,1020439,0.036242603550295856,24500.0,16748166.66666666,2021-06-17
535,197,4846,1025285,0.04065208419314899,32833.333333333336,16780999.999999993,2021-06-18
536,142,4322,1029607,0.03285515964831097,23666.666666666668,16804666.66666666,2021-06-19
537,212,5037,1034644,0.04208854476871154,35333.333333333336,16839999.999999993,2021-06-20
538,162,4723,1039367,0.03430023290281601,27000.0,16866999.999999993,2021-06-21
539,149,3774,1043141,0.03948065712771595,24833.333333333332,16891833.333333325,2021-06-22
540,150,3535,1046676,0.042432814710042434,25000.0,16916833.333333325,2021-06-23
541,160,3510,1050186,0.045584045584045586,26666.666666666668,16943499.999999993,2021-06-24
542,177,4408,1054594,0.04015426497277677,29500.0,16972999.999999993,2021-06-25
543,121,3768,1058362,0.03211252653927813,20166.666666666668,16993166.66666666,2021-06-26
544,102,3170,1061532,0.032176656151419555,17000.0,17010166.66666666,2021-06-27
545,135,4059,1065591,0.03325942350332594,22500.0,17032666.66666666,2021-06-28
546,97,2919,1068510,0.03323055841041452,16166.666666666666,17048833.33333333,2021-06-29
547,121,3463,1071973,0.03494080277216286,20166.666666666668,17068999.999999996,2021-06-30
548,204,4228,1076201,0.048249763481551564,34000.0,17102999.999999996,2021-07-01
549,147,3933,1080134,0.03737604881769641,24500.0,17127499.999999996,2021-07-02
550,135,3291,1083425,0.04102096627164995,22500.0,17149999.999999996,2021-07-03
551,142,3321,1086746,0.042758205359831374,23666.666666666668,17173666.666666664,2021-07-04
552,164,4256,1091002,0.03853383458646616,27333.333333333332,17200999.999999996,2021-07-05
553,123,3072,1094074,0.0400390625,20500.0,17221499.999999996,2021-07-06
554,127,3193,1097267,0.03977450673347949,21166.666666666668,17242666.666666664,2021-07-07
555,131,3231,1100498,0.04054472299597648,21833.333333333332,17264499.999999996,2021-07-08
556,102,3560,1104058,0.028651685393258425,17000.0,17281499.999999996,2021-07-09
557,171,4059,1108117,0.04212860310421286,28500.0,17309999.999999996,2021-07-10
558,107,3098,1111215,0.034538411878631374,17833.333333333332,17327833.33333333,2021-07-11
559,119,4010,1115225,0.029675810473815463,19833.333333333332,17347666.66666666,2021-07-12
560,115,3189,1118414,0.03606146127312637,19166.666666666668,17366833.33333333,2021-07-13
561,100,2919,1121333,0.0342583076396026,16666.666666666668,17383499.999999996,2021-07-14
562,119,3174,1124507,0.03749212350346566,19833.333333333332,17403333.33333333,2021-07-15
563,120,3145,1127652,0.03815580286168521,20000.0,17423333.33333333,2021-07-16
564,98,2926,1130578,0.03349282296650718,16333.333333333332,17439666.66666666,2021-07-17
565,115,2872,1133450,0.04004178272980501,19166.666666666668,17458833.33333333,2021-07-18
566,125,3486,1136936,0.03585771658060815,20833.333333333332,17479666.66666666,2021-07-19
567,157,3271,1140207,0.047997554264750844,26166.666666666668,17505833.33333333,2021-07-20
568,101,2484,1142691,0.04066022544283414,16833.333333333332,17522666.66666666,2021-07-21
569,115,2623,1145314,0.04384292794510103,19166.666666666668,17541833.33333333,2021-07-22
570,108,2917,1148231,0.03702434007541995,18000.0,17559833.33333333,2021-07-23
571,114,2691,1150922,0.042363433667781496,19000.0,17578833.33333333,2021-07-24
572,120,2861,1153783,0.04194337644180356,20000.0,17598833.33333333,2021-07-25
573,120,3094,1156877,0.03878474466709761,20000.0,17618833.33333333,2021-07-26
574,103,2495,1159372,0.04128256513026052,17166.666666666668,17635999.999999996,2021-07-27
575,115,2381,1161753,0.04829903401931961,19166.666666666668,17655166.666666664,2021-07-28
576,92,2025,1163778,0.0454320987654321,15333.333333333332,17670499.999999996,2021-07-29
577,126,2570,1166348,0.0490272373540856,21000.0,17691499.999999996,2021-07-30
578,136,2492,1168840,0.05457463884430177,22666.666666666668,17714166.666666664,2021-07-31
579,194,3712,1172552,0.052262931034482756,32333.333333333332,17746499.999999996,2021-08-01
580,133,3358,1175910,0.03960690887432996,22166.666666666668,17768666.666666664,2021-08-02
581,105,2640,1178550,0.03977272727272727,17500.0,17786166.666666664,2021-08-03
582,125,2399,1180949,0.05210504376823676,20833.333333333332,17806999.999999996,2021-08-04
583,113,2601,1183550,0.04344482891195694,18833.333333333332,17825833.33333333,2021-08-05
584,117,2913,1186463,0.04016477857878476,19500.0,17845333.33333333,2021-08-06
585,115,2528,1188991,0.045490506329113924,19166.666666666668,17864499.999999996,2021-08-07
586,116,2628,1191619,0.0441400304414003,19333.333333333332,17883833.33333333,2021-08-08
587,118,3183,1194802,0.03707194470625196,19666.666666666668,17903499.999999996,2021-08-09
588,162,3022,1197824,0.053606882859033755,27000.0,17930499.999999996,2021-08-10
589,98,2254,1200078,0.043478260869565216,16333.333333333332,17946833.33333333,2021-08-11
590,118,2338,1202416,0.0504704875962361,19666.666666666668,17966499.999999996,2021-08-12
591,193,5278,1207694,0.0365668813944676,32166.666666666664,17998666.666666664,2021-08-13
